title	description	topic	signum
AMC Theatres posts best revenue and attendance since pandemic began as it closes money-losing locations and rakes in cash from 'Barbenheimer' bonanza	The mega movie theater chain has closed 156 locations since the start of the pandemic.		
How to watch or stream Thursday Night Football’s Week 10 during the 2023 NFL season live online free without cable	Here's how to watch Thursday Night Football during the 2023 NFL season online for free—even without a cable subscription.		
Taylor Swift is officially a billionaire thanks to her record-breaking tour and re-recording project, according to Bloomberg	Thanks thanks to her record-breaking Eras Tour and re-recording project, Taylor Swift has a $1.1 billion net worth, according to Bloomberg's estimates.		
Joe Biden is taking a victory lap after the latest blowout GDP report and says the much-feared recession is canceled, but Wall Street is dubious	The Biden Administration celebrated the surge in U.S. GDP growth Thursday, but economists and analysts warn it could be the last hurrah for an ailing economy.		
How to watch or stream Week 7 of the NFL’s 2023 season football live online free without cable	Here's how to watch Week 7 of the 2023 NFL season and your favorite football teams play online for free—even without a cable subscription.		
Rooms, an interactive 3D space designer and ‘cozy game,’ arrives on the App Store	Cozy game, interior decorating app, learn-to-code primer, or something in between, the interactive, 3D spaces builder known as Rooms has made its way to the App Store. The startup, which earlier raised $10 million in seed funding led by a16z, offers a way to …		
Chipotle renames a Kansas City store in honor of Travis Kelce's old, misspelled tweet	It's spelled CHIPOLTE now, thanks to Travis Kelce.		
We need a Taylor Swift and Travis Kelce cover of Teenage Dirtbag as soon as possible	The couple sang this song by a fire pit and we need to hear it.		
Travis Kelce appeared to be all smiles about a 'Karma is a guy on the Chiefs' sign	"Travis Kelce appeared to like the ""Karma is the guy on the Chiefs"" sign."		
Eagles troll Travis Kelce-Taylor Swift relationship with friendship bracelet victory tweet	This is a top-tier troll from the Eagles.		
Jason and Travis Kelce shared a sweet brotherly moment on the field after the Eagles defeat the Chiefs	It took five tries, but Jason Kelce finally got that win over little brother Travis.		
Did Travis Kelce make a subtle reference to Taylor Swift with his touchdown celebration during Eagles - Chiefs?	Taylor Swift might not be attending Monday night’s Kansas City Chiefs game versus the Philadelphia Eagles, but Travis Kelce may have given her a very subtle shoutout with this touchdown celeb…		
Taylor Swift's parents reportedly didn't come to Chiefs - Eagles as planned	The meeting of the parents seems to be understandably postponed as Taylor Swift is still in Brazil.		
NFL fans all had the same joke after Jason Kelce and D’Andre Swift walked in together for Eagles-Chiefs	This is not the Kelce-Swift duo we were expecting!		
Travis Kelce delightfully crashed the ESPN Monday Night Football pregame broadcast	Travis Kelce crashed the MNF pregame broadcast, and it was delightful.		
Taylor Swift incredibly kept performing her Eras Tour Brazil stop after breaking a heel on stage	Someone in the crowd got a very cool souvenir on the final night in Rio.		
Travis Kelce took a playful swipe at Aaron Rodgers in his interview with The Wall Street Journal	Rodgers isn't coming back from that one.		
6 endearing things we learned about Taylor Swift from Travis Kelce's Wall Street Journal interview	Duets at bonfires? Insider help for the meeting?		
The Detroit Lions are heading into Thanksgiving as one of the NFL's best teams and it's so weird	The Detroit Lions are one of the NFL's most fun teams and it's so weird to see.		
Taylor Swift won't be at Eagles - Chiefs ... but will her parents meet the Kelces?	Will Taylor Swift's parents still be at Chiefs - Eagles even if she isn't?		
Billboard Music Awards 2023: Full winners list	Country titans Morgan Wallen and Taylor Swift dominated the Billboard Music Awards with a string of wins, including top artist and top Hot 100 artist.		
Fans think this 2009 Travis Kelce tweet about college football is just so relatable	2009 Travis Kelce was just having a good time.		
The 5 most watchable NFL games for Week 11 2023, ranked	Here are the best games to watch in Week 11.		
Taylor Swift fans think Eras Tour bracelets lit up with Chiefs colors during her End Game performance	Big reputations and now gold and red bracelets!		
The 23 most delightfully goofy Travis Kelce tweets unearthed by Taylor Swift fans	These are all so wholesome.		
The Chiefs welcomed Taylor Swift's dad Scott to their fan base after he wore a Kansas City lanyard	The Chiefs have made their move to officially make Scott Swift one of their fans.		
Donna Kelce discusses seeing The Eras Tour movie and whether Taylor Swift will be there for Chiefs - Eagles	"Momma Kelce said the film adaptation of the popular tour was ""amazing."""		
Fans speculate Travis Kelce keeps texting Taylor Swift during episodes of New Heights podcast	Honestly, if we could text Taylor Swift, we'd be doing it all the time, too.		
Travis Kelce's astonishingly philosophical tweet from 2012 had Taylor Swift fans making so many jokes	When you take your first philosophy class ...		
4 Travis Kelce and Taylor Swift podcast revelations from his Argentina trip, including knowing Karma lyrics would change	Travis Kelce talked with his brother Jason on their New Heights podcast about his trip to see Taylor Swift in Argentina.		
Hear Travis and Jason Kelce's delightful Fairytale of Philadelphia Christmas song duet	The Kelce brothers sound so good together.		
Will Taylor Swift fans send the Travis and Jason Kelce holiday song to No. 1?	That's right, the Kelce brothers have a holiday song coming out!		
OK, fine, Sean Payton. Your plan to turn the Broncos around is finally working	Sean Payton is finally doing the Broncos some good.		
The Taylor Swift bowl, Victor Wembanyama vs. Chet Holmgren and more on this week's betting calendar	NFL Week 11 features a rematch of Super Bowl 57 between the Eagles and Chiefs.		
Taylor Swift fans think her grateful message to Buenos Aires used one of Travis Kelce's favorite phrases	Maybe Taylor Swift already has the word “electric” in her vocabulary — heck, she has a song called Electric Touch! — to describe the die-hard crowds during the Eras Tour, bu…		
Video shows all the times Taylor Swift sang to Travis Kelce at the Eras Tour in Argentina	Taylor Swift made sure Travis Kelce knew she was singing to him.		
Taylor Swift fans remix her Travis Kelce kiss into incredibly beautiful videos	These Taylor Swift and Travis Kelce remixes are the best.		
Taylor Swift and Travis Kelce will be 'engaged by May,' predicts actress Hilarie Burton	We're sure Taylor Swift fans are hoping this prediction comes true.		
USA TODAY Network, Tennessean appoint inaugural Beyoncé reporter	Veteran reporter Caché McClay was chosen to cover Beyoncé's social and cultural influence for The Tennessean and the USA TODAY Network in Nashville.		
Travis Kelce's reaction to Taylor Swift changing the lyrics to Karma to be about him had fans losing it	“Karma is the guy on the Chiefs, coming straight home to me.”		
Taylor Swift fans swoon over Travis Kelce’s hours-long red-eye flight to be at the Eras Tour in Argentina	Travis Kelce took an overnight flight some 5,600 miles across the globe to be there for Taylor Swift!		
Taylor Swift fans think they've found Travis Kelce's plane that's headed to Argentina	Could this be Travis Kelce flying down to see Taylor Swift at the Eras Tour?		
Taylor Swift's new Eras Tour pink outfits had everyone making Barbie (Taylor's Version) jokes	A changed look for Taylor Swift's latest Eras Tour stop in Buenos Aires.		
Taylor Swift fans think her smile during Labyrinth as she sang 'falling in love again' is all about Travis Kelce	Was Taylor Swift singing a message to Travis Kelce during the Eras Tour? Fans think so.		
Travis Kelce had a really good reason for missing Taylor Swift's first Eras Tour show in Argentina	Travis Kelce was in Kansas City for an important event while Taylor Swift kicked off her first show in Argentina.		
NC State football perfectly invoked Taylor Swift for Payton Wilson's postseason awards campaign	This is a winning combo.		
Dry Swifties or Wet Swifties? This Buenos Aires weather report (Taylor's version) is too funny	The buzz is high in Argentina with the Eras Tour starting back up.		
NBA refs ejected Giannis Antetokounmpo against the Pistons for the most pathetic reason	It's always great when officials make the game about themselves, isn't it?		
6 signs Taylor Swift's Reputation (Taylor’s Version) could be dropping soon, according to fans	Could there be any truth to these fan theories about Swift's latest re-release?		
Travis Kelce will travel to Taylor Swift's Eras Tour stop in Argentina, per multiple reports	Multiple reports say Travis Kelce is headed down to Buenos Aires for Taylor Swift's Eras Tour stop there.		
Peyton Manning and Luke Bryan hysterically roasted the Jets with a CMA Awards joke involving Taylor Swift	Jets fans might want to avoid this one.		
Jason Kelce says 'I’m not even the sexiest man in my family' after People's Sexiest Man Alive feature	We assume Jason Kelce is referring to Travis Kelce here.		
Don't let Travis Kelce distract you from Jason Kelce being among People's Sexiest Men Alive	Excuse me, Travis Kelce, but Jason Kelce must be protected AT ALL COSTS.		
Travis Kelce hints at flying to Taylor Swift's Eras Tour stop in Argentina in latest podcast ep	Could Travis Kelce be implying he's flying south to Argentina to see Taylor Swift for her Eras Tour stop?		
5 wildest NFL betting moments (so far) this season, including Patrick Mahomes' slide	There have been plenty of bad beats so far this NFL season.		
Taylor Swift reportedly hosted wives of Travis Kelce's teammates at a Chiefs watch party	Wives of Travis Kelce's teammates were seen leaving Swift's Tribeca home on Sunday.		
The Giants' Daniel Jones era probably just came to a whimpering end with his latest injury	Losing your job to injury is tough. It's about to happen to Daniel Jones.		
NFL Week 9 takeaways: Strange QB matchups make for odd results	The NFL quarterback carousel spun out of control on Sunday, with seven teams making a change at the position from the previous week.		
Taylor Swift hangs with Brittany Mahomes, Sophie Turner in NYC: Photos	Taylor Swift was spotted hanging out in New York City on Saturday with friends Selena Gomez, Brittany Mahomes, Sophie Turner and Gigi Hadid.		
Travis Kelce won't say if Taylor Swift will be in Germany and jokingly blames oddsmakers for it	Those pesky oddsmakers always getting in the way		
Why Travis Kelce and the Chiefs are playing in Germany in Week 9, explained	Here's the answer.		
Taylor Swift fans want to know why Travis Kelce isn't in the Chiefs' latest TikTok	AN INVESTIGATION: The Chiefs are playing checkers while the Swifties are playing chess.		
Mike McDaniel hilariously could not accept that kids were dressing up as him for Halloween	Easily the funniest coach in the NFL.		
16 best celebrity costumes for Halloween 2023, including Paris Hilton as Britney Spears	Not to be dramatic, but some of these are truly iconic.		
NFL Week 8 Awards: Brock Purdy is showing his haters they were all absolutely right	Brock Purdy's critics were correct. He's a system player AND he stinks.		
Chiefs fan Morgan Freeman has no interest in Travis Kelce and Taylor Swift’s love life	Morgan Freeman said what he said.		
Jack Black shamelessly belting out Taylor Swift lyrics in his underwear is glorious	Jack Black is a legend for this.		
Will Taylor Swift keep going to Travis Kelce's games? Let's look at their schedules	Let's look at the Eras Tour schedule and the Chiefs' slate of games to see if we'll see more Swift at his games.		
10 outrageous Dolly Parton covers that don't exist but definitely should exist	There's nothing Dolly can't do.		
NFL fans debated whether or not Josh Allen called a ‘Taylor Swift’ audible or a ‘J.R. Smith’ audible	"Did Josh Allen say ""Taylor Swift"" or ""J.R. Smith"" with this TNF audible call?"		
Taylor Swift fans are convinced 1989 (Taylor’s Version) could be a double album, and they might be right	Are the Swifties on to something here?		
Taylor Swift fans aren't going to be happy with Terry Bradshaw's Eras Tour lip sync theory	Taylor Swift fans might have some beef with Terry Bradshaw over this one.		
The Texas Rangers' run to the World Series is everything we love about sports	The Rangers are doing things the right way and it's so fun to watch		
Taylor Swift is officially a Chiefs fan thanks to the way she sings the national anthem	Taylor Swift is just like every Chiefs fan now.		
The Eagles' Tush Push doesn't need to be banned. Other teams just need to stop it	Don't ban the tush push. Just get a stop.		
Travis Kelce fist-pumps after a ‘Taylor Swift’s boyfriend’ cheer from an enthusiastic fan	Kelce can add one more title to his long list of accolades.		
Taylor Swift's best outfits at Chiefs games, ranked: A running tally of what she's worn to watch Travis Kelce	Breaking down the best Taylor Swift fits at Chiefs games.		
Taylor Swift fans all made the same joke about her and Travis Kelce riding a golf cart to an afterparty	Riding in a getaway car(t).		
What's behind the extreme heat wave in Brazil that forced Taylor Swift to postpone a show	"Thousands of Taylor Swift's fans in Brazil have braved extreme heat to watch the singer perform on her wildly popular ""Eras Tour."""		
GOP rising star Mark Robinson’s wretched Facebook feed lands him in trouble ... again	North Carolina’s lieutenant governor, a rising star in the GOP, appears to have posted comments on Facebook quoting Hitler and minimizing the Holocaust.		
The Philadelphia Eagles' signature 'tush push' is effectively driving its critics mad	"Philadelphia and Jalen Hurts beat the Miami Dolphins on Sunday. The Eagles' only crime with its ""brotherly shove"" is making football fourth downs less dramatic."		
Lionel Messi draws Brazilian fans to what could be his last match in Rio	Many Brazilians have become fans of Lionel Messi in recent years, and his potentially last game in Brazil is drawing many local fans.		
Eagles vs. Chiefs live updates: Top moments from Monday Night Football	Week 11 of the 2023 NFL season comes to a close Monday with the Eagles facing the Chiefs. Here are the top moments!		
What Travis Kelce, Patrick Mahomes, more are saying about Taylor Swift	Several people close to Travis Kelce expressed their thoughts on his relationship with Taylor Swift ahead of Monday's Chiefs-Eagles tilt.		
Eagles hope their new safety has the secret to stopping Travis Kelce	Can anyone slow Travis Kelce? New Eagles safety Kevin Byard will look to try to do just that in Monday's rematch of Super Bowl LVII.		
Buccaneers are on a 3-game skid, but still have a lot to play for this season	Tampa Bay has lost three straight and fallen out of the NFC South lead, but the middle of the NFL is wide open, and playoff contention requires them to be good, not great.		
Buffalo Bills made a philosophical change with Josh Allen in win, but is it sustainable?	The Buffalo Bills got Josh Allen more involved in the running game. It gave them a spark, but is it sustainable?		
What we learned in NFL Week 7: Lamar Jackson as MVP frontrunner; Travis Kelce's immense value	Lamar Jackson is an MVP frontrunner, Travis Kelce showed why he's as valuable to his team as any pass-catcher in the NFL — and that's just a small part of what we learned in Week 7.		
Sportsbooks win big via Patriots upset; college bettors fall flat with USC loss	Sportsbooks won big in NFL Week 7, as the Patriots' shocking outright win over the Bills blew up parlays, Patrick Everson reports.		
Sportsbooks win big in NFL Week 7 thanks to Patriots upset of Bills; college bettors also lose with USC	Sportsbooks won big in NFL Week 7 as the Patriots' upset of the Bills blew up parlays, and USC losing to Utah was bad for bettors, Patrick Everson reports.		
NFL top-10 rankings: Chiefs hold top spot; Eagles, Ravens rise; Dolphins, Lions fall	Kansas City stays No. 1, but the rest of the rankings are a jumble as the Eagles and Ravens fly high while the Dolphins and Lions regroup.		
Eagles defense smothers Dolphins' electric attack in impressive win	Philadelphia's defense shut down the NFL's most dangerous offense, showing the Eagles have many ways to beat anyone they play.		
P.J. Locke saves Denver from another meltdown as Broncos beat Packers 19-17	The Broncos blew a 16-3 lead but ultimately ended a dubious streak in which they had lost 10 consecutive games when leading at halftime.		
Despite three red-zone fumbles, Falcons still beat Bucs to grab first place	Both teams struggled near the goal line, but Atlanta hit a field goal as time expired to beat the Bucs and move into first place in the NFC South.		
Browns edge Myles Garrett dominates in win over Colts: 'Man, 95 is a problem'	Myles Garrett's Sunday: nine tackles, two sacks, two forced fumbles, a pass breakup and a blocked field goal. Oh, and the Browns won 39-38.		
LeBron James to clap back at Nuggets' trash talk? 'There will be a time'	With the Los Angeles Lakers and Denver Nuggets' season opener around the corner, LeBron James weighed in on all the trash talk he has absorbed.		
Canada’s economy faces $900-billion mortgage renewal shock	The biggest shock awaits variable-rate mortgages set to renew in 2026. A five-year variable mortgage renewing in October of that year would see payments jump 76 per cent if mortgage rates stayed around 6 per cent		
Shelter aid sticking points			
Let's be clear about what 'dark money' is			
Guy's night out			
Migrant crisis comes to a head			
Biden world sinks its claws into Phillips	And Vice President Kamala Harris is in London this morning ahead of the kickoff of the big Global AI Safety Summit		
The phantom menace			
Playbook: New speaker, new attitude	And the White House rebuked a comparison of Israel to Russia.		
Ballot questions put to an early test			
'We found a way': Hurts' take on Eagles-Chiefs leads NFL's top Week 11 quotes	From the Chargers' head coach getting feisty to a Broncos safety defending his now-suspended teammate, NFL Week 11 action provided an abundance of memorable quotes.		
How Patriots coach Bill Belichick helped Josh Uche ignore the trade deadline noise	"Uche credits ""some open, transparent dialogue with Bill"" for helping him work through hearing his name involved in trade buzz."		
Hype Trap Bet: Joshua Dobbs' case for Comeback Player of the Year	Joshua Dobbs has taken the league by storm. Kevin Pulsifer analyzes his chances to win Comeback Player of the Year as the underdog story of the 2023 season.		
Why football in Premier League and Europe is anything but a fair fight	It's not surprising that big teams with lots of resources and money might win more trophies -- just look at Man City's dominance in recent seasons -- but what might surprise you is the sheer scale of this inequality.		
The NFL's stalled running back market, three months later: Barnwell on what's next for the position	Let's check in with eight running backs who dominated the conversation in the offseason. Are they living up to expectations?		
The late-night dive to rescue the Bedlam goalposts after Oklahoma State's historic win	Hours after Oklahoma State took down rival OU in their final matchup, a few Cowboys fans went hunting for a piece of Bedlam history.		
Kelce: Chiefs have every piece needed to be great	The Chiefs heading into Sunday's game against the Dolphins haven't been an offensive power like in previous seasons. But tight end Travis Kelce said that's not because the Chiefs are deficient at wide receiver.		
Mike Clay's NFL Betting Playbook for Week 9	Mike Clay pits his projection system against the sportsbooks with a game-by-game look at Week 9 player props, offering his leans for taking the over or the under.		
'You're a wizard, Harry': Notable trends from Diamondbacks' last World Series win	Some of the top Arizona Diamondbacks' players were just infants the last time Arizona made the World Series in 2001.		
Hype, Trap, Bet: How to handle the Michigan scandal	Kevin Pulsifer looks at a tumultuous Wolverines program that's somehow heading in opposite directions at the same time.		
Union Berlin are no longer an underdog fairytale, but they're worth rooting for	Union Berlin's players couldn't believe the support of their home fans as their losing streak stretched to nine games on Tuesday night. But that's what makes this club, and its supporters, so special.		
Underdogs bite betting public on big Sunday for sportsbooks	The betting public took a big hit on Sunday after two popular underdog teams failed to live up to expectations. David Purdum breaks it all down.		
Trump Is Still Obsessed With the ‘Golden Showers’ Rumor	Most of us have stopped thinking about the fabled ‘pee tape,’ but Donald Trump won’t let us forget it. He told Iowa rallygoers that Melania didn’t believe the golden showers story, though nobody asked.		
Fabian Basabe Will Not Be Canceled	Fabian Basabe, the party boy turned Miami GOP politico, fights off sexual harassment claims by male staffers and plots his future. (His wife stands by him.)		
This AI Quiz Will Turn Your Life Into A Taylor Swift Song In Like, 15 Seconds	I'm all ears...View Entire Post ›		
Just 43 Things That’ll Be Super Easy To Wear With Stuff You Already Own	Because sometimes you just need the right pants to go with a certain top.View Entire Post ›		
55 Unexpected Gifts That'll Put Santa To Shame	Commemorative Taylor Swift tickets, Renaissance cat calendars, Love Island tumblers, and tons of other fun items your giftee had no idea they needed.View Entire Post ›		
34 Beauty Products With Before And Afters That’ll Seriously Wow You	Your jaw is gonna drop when you see what the biotin shampoo could do for you.View Entire Post ›		
"The ""22"" Hat Taylor Swift Gives Away Every Night On Tour Costs Almost $400, Plus 26 Other BTS Facts About Her Eras Tour Wardrobe"	Taylor's 16 costume changes involve wayyy more Swarovski crystals than you might think!View Entire Post ›		
36 Incredible Products I Think About Even More Than Taylor Swift And Travis Kelce (And I Think About Them A *Lot*)	I look at this $5 holy grail mascara the same way Trav looks at Taylor.View Entire Post ›		
Reviewers Swear By These 28 Makeup Products Under $25	From setting spray to a top-rated brow pencil, get the most bang for your buck with these reviewer-loved makeup must-haves.View Entire Post ›		
Taylor Swift Went Out With A Large Group Of Famous Girlfriends, And It's Just Looking Worse And Worse For Joe Jonas	I imagine them doing some sort of Hocus Pocus hexing spell while eating the biggest ball of burrata you've ever seen.View Entire Post ›		
A Reporter Asked Travis Kelce The Status Of His Relationship With Taylor Swift, And Fans Love His Response	Travis is keeping his cards close to his chest.View Entire Post ›		
46 Beauty Products That Really And Truly Solve Problems	We're human, we have problems — but these products will make them ( poof) ~disappear~.View Entire Post ›		
If You’re Always Running Late, Here Are 43 Products To Help You Get Back Some Time In Your Day	Including a sunrise alarm clock that will wake you up gradually so you don't have to hit snooze 15 times.View Entire Post ›		
41 Pieces Of Clothing And Shoes For Anyone Who Has Been Wearing Black Long Before Wednesday Addams	Your closet will be dancing like Wednesday after you finish shopping this post.View Entire Post ›		
"Here's What People Are Saying After Kelly Clarkson Responded To Claims She ""Bashed"" Taylor Swift And Travis Kelce"	"""Do not fall prey to clickbait, trash reporters twisting the facts again.""View Entire Post ›"		
41 Things That'll Make You Want To Start Writing Your Holiday Wish List Now	A monthly book subscription, a soft serve maker, Taylor Swift-inspired embroidered sweatshirts, and more great things you'll want to add to your own holiday wish list this season.View Entire Post ›		
Feds Subpoena Ticketmaster Over Egregious Concert Prices After It 'Stonewalled' Lawmakers	A spokesperson for Live Nation, which owns Ticketmaster, said the firm doesn't “feel comfortable” sharing information with Congress.		
iPad Kids Are Getting Out of Hand	"Millennials are raising ""bizarre and terribly behaved” children, glued to screens. Can Gen Z flip the script?"		
House may consider Mayorkas impeachment this week	The House may consider a resolution this week that aims to impeach Homeland Security Secretary Alejandro Mayorkas after a push by Rep. Marjorie Taylor Greene (R-Ga.) to do so, according to the chamber’s schedule of measures it plans to consider. The Mayorkas …		
Shiffrin turns page on busy off-season, begins pursuit of record-tying 6th overall World Cup title	Keeping up with Mikaela Shiffrin's off-season endeavours may be just as challenging as catching up to her in a ski race. She's constantly full speed ahead.		
Eagles couldn’t help themselves by making a Taylor Swift reference after win over Chiefs	The Philadelphia Eagles are celebrating their win on “Monday Night Football” against the Kansas City Chiefs with an apparent nod to Travis Kelce’s relationship with Taylor Swift.		
Taylor Swift’s Rio tour marred by deaths, muggings and a dangerous heat wave	Taylor Swift's three-day leg of her eras tour in Rio de Janeiro, Brazil was marred by the deaths of two people, extreme heat and muggings and crime, as fans decried on social media.		
Nikki Haley's abortion messaging and X sues Media Matters: Morning Rundown	OpenAI employees threaten to leave after CEO Sam Altman's ouster.		
Jalen Hurts leads second-half rally as Eagles beat Chiefs 21-17 in Super Bowl rematch	The Philadelphia Eagles rallied from a 10-point halftime deficit to beat the Kansas City Chiefs 21-17 in a Super Bowl rematch Monday night.		
Taylor Swift concert runs into brutal Brazilian heat wave	The death of a Taylor Swift fan at her recent concert in Rio de Janeiro comes during a brutal heat wave that has hammered parts of Brazil.		
Biden confuses Taylor Swift with Britney Spears in remarks on his 81st birthday	President Joe Biden mixed up Taylor Swift and Britney Spears in remarks Monday during the White House’s annual turkey pardoning ceremony, which happened to fall on the president’s 81st birthday.		
Taylor Swift Rio concert chaos: Fans describe ‘unbearable' Friday show	"Fans in Rio de Janeiro waited years for Taylor Swift to come to their city. When she finally did, “everything that could have gone wrong did,"" one fan said."		
Biden to celebrate his 81st birthday pardoning Thanksgiving turkeys	President Joe Biden will be spending his 81st birthday Monday carrying out an annual White House tradition: pardoning two lucky turkeys.		
How Taylor Swift transcends America's political divides — barely	Pop star Taylor Swift notched the highest net favorability ratings of any figure tested in the latest NBC News national poll.		
Biden and Xi announce new agreements and mother of 6-year-old who shot teacher sentenced: Morning Rundown	Chinese president Xi Jinping and President Joe Biden find common ground.		
How Taylor Swift and Travis Kelce are inspiring people to raise their dating standards	It’s a love story that people just want to say yes to: Taylor Swift and Travis Kelce — who have been rumored to be dating since September — are inspiring people to step up their own dating expectations.		
Taylor Swift asks fans not to throw objects on stage	Taylor Swift asked fans at her Buenos Aires concert on Sunday night to not throw objects on stage, saying “it really freaks me out.”		
Gaza's main hospital 'no longer functioning' and Tim Scott suspends campaign: Morning Rundown	Get everything you need to know to start your day. Sign up to get the Morning Rundown newsletter to your email inbox.		
Taylor Swift cancels Friday night show in Buenos Aires after Travis Kelce arrives in Argentina	Taylor Swift called off her Friday night Eras Tour show in Buenos Aires due to intense rain even after Travis Kelce showed up to watch her perform.		
Taylor Swift makes Grammy Awards history with most song of the year nominations	Taylor Swift made history when the nominations for 2024 Grammy Awards were announced on Friday. The music superstar became the first person to be nominated in the song of the year category seven times.		
Taylor Swift delights Argentina concert fans with popular Spanish slang	"Taylor Swift fans went wild in Argentina when she swapped the words ""like ever"" for a Spanish expression popular in Argentina, and the crowd went wild."		
Taylor Swift's headed to Argentina for her Eras Tour — Travis Kelce plans to be there, too	Taylor Swift has been on the sidelines rooting Travis Kelce on while he works, and now, he's expected to travel to Argentina as her Eras Tour resumes.		
Taylor Swift’s Eras Tour concert film takes its final bow at the box office this weekend	Taylor Swift takes her final bow at the movie box office this weekend.		
NewJeans says they’re more than solely K-pop stars as they break global barriers	NewJeans is reflecting on being the first K-pop girl group to be nominated for the “Top Billboard Global (Excl. U.S.) Artist” award.		
Halloween 2023: A look at the viral moments that inspired people's costumes this year	Many online are sharing their Halloween costumes that were inspired by viral moments, pop culture trends and iconic internet memes.		
Chiefs lose, Travis Kelce has a tough day in Taylor Swift's absence	High-profile tight end Travis Kelce underperformed against expectations Sunday in the Kansas City Chiefs' loss to the Denver Broncos — and his reported sweetheart, Taylor Swift, wasn't there to see it.		
‘1989 (Taylor’s Version)’ is coming. Here’s what to know.	‘1989 (Taylor’s Version)’ features vault tracks: “Now That We Don’t Talk,” “Suburban Legends,” “Say Don’t Go,” “Is It Over Now?” and “‘Slut!’”		
Taylor Swift kisses Travis Kelce on the cheek in Instagram photo	Taylor Swift and Travis Kelce are getting just a little bit more cozy in a new snap that has fans buzzing.		
Taylor Swift wears friendship bracelet with Travis Kelce’s jersey number at Chiefs-Chargers game	Taylor Swift might be the Kansas City Chiefs’ good luck charm.		
Taylor Swift's Eras Tour linked to unfortunate circumstances in Rio, including fan deaths and dangerous heat	Taylor Swift's Eras Tour has been marred by the deaths of fans, muggings and a dangerous heat wave in Rio de Janeiro. On Friday, a fan fell ill during the show and later died.		
‘Hunger Games’ prequel tops box office with $44 million opening in North America	"The ""Hunger Games"" prequel, ""The Hunger Games: The Ballad of Songbirds & Snakes"" has brought in an estimated $44 million in ticket sales at the North American box office."		
Taylor Swift suffers wardrobe malfunction on stage during Brazil 'Eras Tour' stop	"Taylor Swift's heel broke off during the ""Lover"" set of ""The Eras Tour"" in Brazil. The ""Midnights"" singer took the stage Monday night for a rescheduled show following ""extreme"" weather."		
Donna Kelce regrets calling Taylor Swift 'okay' in interview, says son Travis is 'happier' in life	Travis Kelce's mom, Donna Kelce, apparently has regrets over how she answered a question about Taylor Swift, but her son assured her she handled it perfectly.		
Taylor Swift's beau Travis Kelce details their courtship; Sami Sheen reveals she had a boob job	The Fox News Entertainment newsletter brings you the latest Hollywood headlines, celebrity interviews and stories from Los Angeles and beyond.		
Tom Brady rips 'mediocrity in today’s NFL,' takes issue with 'product' on the field	"Tom Brady expressed his frustration with what he's been seeing on the NFL field and the officiating. He made his comments on the ""Stephen A. Smith Show."""		
Chiefs' Marquez Valdes-Scantling drops go-ahead TD pass, smashes helmet in frustration	Kansas City Chiefs wide receiver Marquez Valdes-Scantling dropped a key pass late in their loss against the Philadelphia Eagles. The catch would have been the go-ahead score.		
Travis Kelce breaks scoreless drought but key fumble contributes to Chiefs loss sans Taylor Swift	Travis Kelce made an impact early for the Kansas City Chiefs, but key mistakes stymied the team in their narrow loss to the Philadelphia Eagles.		
Sofia Vergara admits divorce contributed to 'interesting and very difficult' year	"Sofia Vergara admitted that she had a ""very interesting"" and ""very challenging"" year following her divorce from her husband of 7 years, Joe Manganiello."		
Biden’s birthday present: Abysmal polls and growing concern about his age	As President Biden's foreign policy blunders mount, the Democratic base grows weary in their enthusiastic support of the 81-year-old president.		
Biden's Taylor Swift-Britney-Beyoncé mix-up sparks social media mockery: 'This is an impeachable offense'	President Biden appeared to confuse pop singers Britney Spears, Beyoncé and Taylor Swift during his comments at the annual turkey pardon at the White House on Monday.		
Biden mocked after confusing pop music stars during turkey pardoning joke: 'Impeachable offense'	Social media users piled on President Biden after he botched a joke Monday that appeared to be targeting young voters due to their enthusiasm for the pop music stars.		
Coddling in college: ‘Helicopter parents’ use Facebook groups to arrange playdates, warn about non-vegan food	"A growing number of parents are using WhatsApp and Facebook groups to help assist their children away at college, arranging ""playdates,"" haircuts and more."		
Travis Kelce admits he thinks about retirement 'more than you can imagine'	Kansas City Chiefs tight end Travis Kelce has no intentions of hanging up his NFL cleats, but he admitted in an in-depth profile that he thinks about retirement nonstop.		
Taylor Swift's boyfriend Travis Kelce finally reveals how they met: 'She'll probably hate me for saying this'	Taylor Swift's boyfriend Travis Kelce is sweetly spilling all the details about how he and the popstar first started dating, and he gave kudos to her inner circle.		
Super Bowl champ dishes on Taylor Swift effect on NFL: 'I think it makes it fun'	New York Giants legend weighed in on the Taylor Swift effect on the NFL amid her relationship with Kansas City Chiefs superstar Travis Kelce.		
Biden cracks age joke on 81st birthday, then confuses Taylor Swift, Beyonce	President Biden, who turned 81 today, made jokes about his age during the White House turkey pardon before mixing up Taylor Swift and Beyonce in a remark.		
Taylor Swift gets emotional on stage performing song 'Bigger Than the Whole Sky' after fan's death	Taylor Swift appeared to pay tribute to a fan who died before her Eras tour performance on Friday in Rio de Janeiro, Brazil, after the city faced a heat wave.		
Eagles troll Travis Kelce ahead of major Monday night matchup	The Philadelphia Eagles may have given the Kansas City Chiefs some bulletin board material ahead of Monday night's matchup. They took aim at Travis Kelce.		
Taylor Swift returns to Rio stage after postponing Eras Tour concert, fan death	Taylor Swift resumed The Eras Tour in Brazil after canceling concert on Nov. 18 due to record heatwave across Rio. One fan died Friday after fainting outside stadium.		
Patrick Mahomes approves of Travis Kelce's relationship with Taylor Swift: 'It's not become a distraction'	Chiefs quarterback Patrick Mahomes gave his stamp of approval of Travis Kelce's relationship with Taylor Swift, saying it's not a distraction to the guys in the locker room.		
NFL Week 11 preview: Chiefs-Eagles headline schedule as eyes turn back to Travis Kelce, Taylor Swift	NFL fans and the pop culture world will likely be tuning in Monday night for the Kansas City Chiefs and Philadelphia Eagles, but don't count out Sunday's slate.		
Taylor Swift postpones Brazil concert due to 'extreme temperatures'	"Taylor Swift announced that her Saturday night Eras concert in Rio de Janeiro has been postponed due to ""extreme temperatures."""		
Taylor Swift fan details scorching, 'sauna-like' conditions at Brazil show that left 23-year-old dead	A passionate Taylor Swift fan gave a glimpse of her experience at the chaotic Brazil concert that left a 23-year-old person dead after severe weather conditions.		
Taylor Swift’s dad gets apology from Travis Kelce; Will Smith, Jada Pinkett Smith deny cheating claims	The Fox News Entertainment newsletter brings you the latest Hollywood headlines, celebrity interviews and stories from Los Angeles and beyond.		
Taylor Swift ‘devastated’ as fan dies before Brazil concert	A Taylor Swift fan died before her opening night concert in Rio de Janeiro, Brazil, Friday. Swift shared a statement on her social media mourning the loss of the fan.		
Taylor Swift hints Travis Kelce romance is serious with these subtle clues	Taylor Swift has dropped subtle clues about her relationship with Travis Kelce. Her fans have picked up on hints the romance is getting serious during The Eras Tour.		
Philadelphia radio station says it won't play Taylor Swift songs ahead of Eagles-Chiefs Super Bowl rematch	The Kansas City Chiefs host the Philadelphia Eagles Monday night, and a Philly radio station is banning Taylor Swift songs until after the game.		
Drew Barrymore doesn't want plastic surgery: 'I worry I'd continue to chase it'	"Drew Barrymore says that she's never had plastic surgery and doesn't picture herself getting any, saying her ""highly addictive personality"" might cause her to go overboard."		
'Trolls 3' director taps into NSYNC fever, 90s nostalgia in latest installment of hit series	"The director of ""Trolls 3"" reflects on how his film's NSYNC reunion melted millennial hearts and why the famed boy band's music continues to resonate decades later."		
Taylor Swift honored on Christ the Redeemer statue: 'Welcome to Brazil'	"Taylor Swift was honored with a projection on Brazil's Christ the Redeemer statue of a shirt inspired by the superstar's ""Junior Jewels"" shirt from her ""You Belong With Me"" music video."		
'Kelce' becomes a top trending dog name in America, pet company's data shows	"Recent data from Rover has shown that a top trending dog name in America right now is ""Kelce,"" amid coverage of the Kansas City Chiefs player and girlfriend Taylor Swift."		
Michigan's Jim Harbaugh agrees to serve 3-game ban, Big Ten drops sign-stealing investigation	Michigan coach Jim Harbaugh agreed to serve a 3-game suspension over the school's sign-stealing scandal and the Big Ten has dropped its investigaton.		
3 ways to increase your privacy and save money when booking travel	"Kurt ""CyberGuy"" Knutsson takes on protecting privacy and saving money while booking travel plans through the use of creating an email alias."		
DC pro-Palestinian protest turns violent, Senate averts shutdown, passes funding bill and more top headlines	Get all the stories you need-to-know from the most powerful name in news delivered first thing every morning to your inbox.		
Taylor Swift, Travis Kelce's long distance romance has fans anticipating next rendezvous	Taylor Swift embarks on Brazilian leg of her Eras Tour this week through Thanksgiving, leaving little time for new romance with boyfriend Travis Kelce.		
JESSE WATTERS: The chemistry between Biden and Xi was unmistakable	"Jesse Watters highlights how President Biden cozied up to president Xi during their meeting in San Francisco on ""Jesse Watters Primetime."""		
Taylor Swift tour may prevent Thanksgiving at home with Travis Kelce	Taylor Swift's first Thanksgiving with Travis Kelce may be over FaceTime as she continues Eras Tour in Brazil while he plays football with Kansas City Chiefs.		
Patriots legend Rob Gronkowski says Mac Jones should ask for release now: 'He's not respected'	Mac Jones' tenure with the New England Patriots has hit rock bottom at 2-8 in his third season, and legend Rob Gronkowski believes he should ask for his release now.		
'Brady Bunch' star Barry Williams, 69, shocks 'DWTS' crowd by ripping off shirt: 'I'm gonna chuckle forever'	"'Brady Bunch' star Barry Williams, 69, reflected on his ""Dancing with the Stars"" experience with Fox News Digital as he exits the competition after being eliminated."		
Travis Kelce issues apology to Taylor Swift's dad Scott after concert flub	Travis Kelce spilled on his trip to Argentina to visit girlfriend Taylor Swift and hilariously apologized to her father, Scott, for an awkward flub he made during the concert.		
Taylor Swift, Travis Kelce meet the parents: Who's who in each famous family	As Taylor Swift and Travis Kelce's relationship continues to grow, they have been spotted spending time with each other's parents, who appear to be supportive of the romance.		
Travis Kelce, Taylor Swift budding relationship draws wholesome remark from Andy Reid	Kansas City Chiefs head coach Andy Reid remarked on Travis Kelce's relationship with Taylor Swift as he spent his bye week in Argentina to see the pop star.		
Taylor Swift surprises Travis Kelce at concert, pleads with fans to stop throwing things on stage	The Fox News Entertainment newsletter brings you the latest Hollywood headlines, celebrity interviews and stories from Los Angeles and beyond.		
Taylor Swift jokes about witchcraft, 'never beating the sorcery allegations' after crazy concert moment	Taylor Swift is poking fun at long-standing rumors that she is a witch, sharing a bizarre moment from her Argentina shows that points to that narrative.		
Taylor Swift, Travis Kelce's PDA signals NFL player is 'endgame' for pop star: expert	"Taylor Swift and Travis Kelce took their relationship public during the ""Karma"" singer's ""Eras Tour"" with new lyrics and a kiss. Experts explain the change in Swift's stance on privacy."		
Bills penalty results in heartbreaking loss after Broncos get second chance at game-winning field goal	The Denver Broncos sealed the deal against the Buffalo Bills, 24-22, on Monday night after getting another chance to kick a game-winning field goal following a Bills penalty.		
SNL's Hamas joke in Timothée Chalamet skit infuriates pro-Palestinian voices online	"A ""Saturday Night Live"" skit that included a joke about Hamas infuriated pro-Palestinian voices over the weekend, who said it made light of ""genocide."""		
US professors use pop culture icons like Taylor Swift and Rick Ross to make law school more engaging	Law professors across the U.S. are incorporating pop culture icons like Taylor Swift and Rick Ross into their courses in an effort to engage students.		
Taylor Swift pleads with fans after item is thrown onstage during Eras Tour concert: ‘It really freaks me out’	After objects were thrown onstage, Taylor Swift politely asked her audience in Argentina to refrain, as it endangers her dancers and scares her.		
Young Taylor Swift played a song backstage for Britney Spears during 'Oops! ... I Did it Again' tour	"Britney Spears reflected upon meeting a young Taylor Swift, before she was famous, at her own ""Oops! ... I Did It Again"" tour. Spears says Swift played her a song on the guitar."		
Taylor Swift runs to kiss Travis Kelce after he attends her second Eras show in Argentina	Taylor Swift and Travis Kelce shared a kiss after the singer rushed into the NFL star's arms following her second Eras tour concert in Argentina.		
Taylor Swift postpones Argentina concert after Travis Kelce arrives	"Taylor Swift canceled the Nov. 10 concert of the international leg of ""The Eras Tour"" due to ""chaotic"" weather. Her rumored boyfriend, Travis Kelce, just arrived in the country."		
Taylor Swift fans go wild as she sings about 'falling in love again' while kicking off international tour	"Taylor Swift shocked fans Thursday by singing about ""falling in love again"" amid her romance with NFL star Travis Kelce. The pop star performed ""Labyrinth"" in Buenos Aires for the first time on her Eras Tour."		
GREG GUTFELD: Hillary Clinton's interview on 'The View' shows she's still 'hung up' on Trump	"FOX News host Greg Gutfeld reacts to Hillary Clinton's Trump focused interview on ""The View"" on ""Gutfeld!"""		
Mom told to remove decorations from son's gravesite — plus Taylor Swift 'swear jar' goes viral	The Fox News Lifestyle Newsletter brings you trending stories on family, travel, food, neighbors helping neighbors, pets, autos, military veterans, heroes, faith and American values.		
Travis Kelce will travel to Argentina to see Taylor Swift's 'Eras Tour': report	"Kansas City Chiefs tight end Travis Kelce is going to use the bye week to reportedly head down to Argentina in support of Taylor Swift's ""Eras Tour"" beginning international stops."		
2023 CMAs co-hosts Luke Bryan, Peyton Manning joke about Taylor Swift, Travis Kelce at award show	The 2023 CMA Award co-hosts, Luke Bryan and Peyton Manning, took a moment during the show to make a Taylor Swift, Travis Kelce joke. Manning also poked fun at the New York Jets.		
Couple's viral 'Taylor Swift Jar' has wife paying a quarter whenever she mentions the star	"A Maryland realtor and her husband went viral after a ""Taylor Swift Jar"" was made. If someone mentions Swift or Travis Kelce, a quarter is required to be added to the jar."		
Chiefs' Travis Kelce hints at traveling to South America to support Taylor Swift's tour during team's bye week	During a recent podcast episode, two-time Super Bowl champion Travis Kelce played coy about potentially traveling to South America to take in one of Taylor Swift's Eras Tour shows.		
Taylor Swift & Brittany Mahomes party before Chiefs game, King Charles' reported control over Harry & Meghan	The Fox News Entertainment newsletter brings you the latest Hollywood headlines, celebrity interviews and stories from Los Angeles and beyond.		
Taylor Swift supports Travis Kelce with rare social media move	Taylor Swift liked an Instagram post about Travis Kelce's performance from his game in Germany on Sunday, sending fans into a frenzy over the public act of support.		
Giants' Daniel Jones suffers torn ACL, season likely over for star QB	New York Giants quarterback Daniel Jones will miss the rest of the season as Brian Daboll announced he tore his ACL in Sunday's game against the Las Vegas Raiders.		
Travis Kelce faces jabs after another quiet game without Taylor Swift in attendance	Kansas City Chiefs tight end Travis Kelce faced some ribbing on social media as he had another quiet game with Taylor Swift not in attendance.		
Chiefs' wild fumble-return sequence leads to improbable touchdown vs Dolphins	A wild fumble return helped the Kansas City Chiefs take a comfortable lead into halftime against the Miami Dolphins in Germany on Sunday.		
Can Republicans flip New Jersey’s state legislature from blue to red?	New Jersey Republicans face a tough challenge Nov. 7, with Democrats in control of both chambers of state government and the governor's office		
Travis Kelce asked if he's 'in love' with Taylor Swift, addresses relationship 'status'	"Travis Kelce and Taylor Swift are all but officially official, which prompted a reporter in Germany to ask the Chiefs star if he's ""in love."""		
Travis Kelce's mom explains why Chiefs star has taken game to 'new level' amid Taylor Swift relationship	Travis Kelce's relationship with Taylor Swift led some to believe he wouldn't perform well for the Chiefs this season, but his mother, Donna Kelce, explained why it motivates him more.		
Travis Kelce plays into joke that Taylor Swift 'put me on the map'	"Travis Kelce is getting in on the joke that Taylor Swift put him ""on the map."" The narrative even inspired a couple's Halloween costume, which Kelce ""enjoyed."""		
Donna Kelce talks NFL's new viewership due to Taylor Swift's presence: 'I'm sure they're extremely happy'	Donna Kelce, the mother of Jason and Travis Kelce, discussed how she believes the NFL feels with Taylor Swift's presence at Kansas City Chiefs games resulting in boosted ratings.		
Diet Coke-obsessed mom from Kentucky reveals her viral collection and 'the joy it brings me'	A viral Diet Coke lover from Kentucky — a mom named Beth Sturgill — has come forward to share her soft drink memorabilia; it's all found inside her Lexington home. See the pix!		
Kelly Clarkson ripped her pants while filming 'Since You've Been Gone' music video: ‘I was commando’	"Kelly Clarkson revealed that she ripped her pants while filming the music video for ""Since You've Been Gone,"" when speaking to Kyle Richards."		
Travis Kelce faces criticism from Chiefs great for World Series attendance: 'Let this be a lesson'	Kansas City Chiefs great Nick Lowery took issue with Travis Kelce making an appearance at the World Series before the team was in Denver and lost to the Broncos.		
Taylor Swift skips Travis Kelce's football games for Eras Tour prep	Taylor Swift has been a staple at Travis Kelce's Kansas City Chiefs games as of late, but she missed a recent game to focus on her upcoming Eras Tour stops in South America.		
Fox News Politics: The next ambassador to Israel	The latest updates from the 2024 campaign trail, exclusive interviews and more Fox News politics content		
Taylor Swift, Travis Kelce Halloween costume wins friends a top prize: See their rendition of the stars	Florida friends dressed up as Taylor Swift and Travis Kelce for a Halloween costume contest and took home the grand prize. See the pair mimick the iconic duo!		
NJ Gov Phil Murphy used thousands in taxpayer funds to party at Taylor Swift concert, stadium events: report	New Jersey Gov. Phil Murphy reportedly spent nearly $12,000 in taxpayer funds at MetLife stadium since 2018, including at a Taylor Swift concert.		
‘Five Nights at Freddy’s’ dominates Halloween weekend with $78 million debut in North America	"The simultaneous release of ""Five Nights at Freddy's"" in theaters and on streaming had little impact on the film's success on the big screen Halloween weekend."		
Broncos troll Chiefs by blasting Taylor Swift hit throughout the stadium after major upset	The Denver Broncos had a little fun at the expense of Chiefs' star Travis Kelce after they defeated Kansas City on Sunday for the first time since 2015.		
Literary legend haunted hotel for 53 years until neglected remains buried with family in NYC, say historians	The ashes of American literary icon Dorothy Parker reportedly haunted the Algonquin Hotel for more than 50 years, before she was buried beside family in New York City.		
Matthew McConaughey, Sharon Osbourne, Helena Bonham Carter share ghost stories: 'Something weird happened'	Sharon Osbourne, Matthew McConaughey, Helena Bonham Carter, Lily Collins and Megan Mullally share their stories of ghosts and hauntings.		
AJ Brown sets NFL record as Eagles use second-half surge to beat Commanders	Philadelphia Eagles star wide receiver A.J. Brown was back dazzling everyone on Sunday as he broke the NFL record for most 125-plus receiving yards in six straight games.		
Halloween candy vs. healthy parenting: Here's how to make it all work	Parenting is hard, especially with candy companies trying turn Halloween into an all-year sugar-buzz festival. We can help them grow without ruining their childhoods.		
Chiefs star Travis Kelce dances to Taylor Swift's 'Shake It Off' at World Series game	The Kansas City Chiefs star broke out some dance moves to one of Taylor Swift's hit songs during his appearance at Game 1 of the World Series between the Rangers and Diamondbacks.		
Jennifer Lawrence's full-frontal nude scene; Morgan Wallen looks for love	The Fox News Entertainment newsletter brings you the latest Hollywood headlines, celebrity interviews and stories from Los Angeles and beyond.		
Taylor Swift to likely miss Travis Kelce's Chiefs game this Sunday as 'Eras Tour' nears return: reports	The Grammy Award winning singer has become a fixture at Chiefs home and road games so far this season, where she has supported Travis Kelce from luxury suites.		
Patrick Mahomes wants to 'one-up' Taylor Swift and his wife's handshake with Travis Kelce	When Taylor Swift and Patrick Mahomes' wife went viral for their two handshakes, the quarterback realized he didn't have one with Travis Kelce.		
Taylor Swift releases reimagined '1989' album, reviving nostalgia during new era of career	"Taylor Swift has released her reimagined ""1989"" album. The original album marked the beginning of her singing career's shift from country to pop and now is being revisited."		
US strikes Iran-linked sites in Syria, elite border unit joins hunt for Maine suspect and more top headlines	Get all the stories you need-to-know from the most powerful name in news delivered first thing every morning to your inbox.		
Taylor Swift embraced by Travis Kelce's Kansas City Chiefs crew: 'She's letting her guard down,' expert says	"Taylor Swift has been welcomed like ""family"" into Travis Kelce's Kansas City Chiefs crew, according to a body language expert who analyzed the pop star's moves with her new friends."		
Rob Gronkowski says NFL is overdoing it with Taylor Swift coverage during games: ‘We want more football’	"Rob Gronkowski thinks the NFL is giving Taylor Swift “too much"" screen time during games and says the league should “show the players"" more."		
Taylor Swift and Travis Kelce relationship works because ‘they’re very supportive of each other,’ his dad says	"Taylor Swift will soon release her next re-recorded album, and Travis Kelce's dad will be in line to purchase as he boasted that the ""Cruel Summer"" singer is ""very genuine."""		
Eagles' Jason Kelce expresses concern for brother Travis Kelce amid budding romance with Taylor Swift	"Jason Kelce is ""happy"" for brother Travis Kelce amid his budding romance with pop sensation Taylor Swift, but he does have one possible concern."		
GOP confident Johnson will be speaker, Biden megadonor criticized for tech board seat and more top headlines	Get all the stories you need-to-know from the most powerful name in news delivered first thing every morning to your inbox.		
Taylor Swift, Travis Kelce break NFL WAG curse: Jessica Simpson, Carrie Underwood once blamed for losses	Taylor Swift and Travis Kelce's new relationship fills the blank space that the NFL needs to recover from the alleged curse when Hollywood stars date football players.		
In time for Halloween, Washington driver caught in HOV lane with creepy clown dummy and assessed scary ticket	A driver was caught by the Washington State Patrol in the high-occupancy vehicle lane with a creepy Halloween clown tied to the passenger seat.		
NFL Player on RB Contract Debate: 'If I Was Ever a GM, I Would Never Pay a RB'	It's not only NFL general managers who don't want to hand out big-money contracts to running backs. In a player survey conducted by The Athletic, one player…		
Fantasy Football Week 11: Examining Trade Value for This Year's Top 100 Players	Let's be honest—if you are reading this, your fantasy team probably isn't good enough to win a title and you are scouring the trade market, hoping to fleece…		
Fantasy Football Week 10: Updated Trade Value for Top 100 Players	There have been so many injuries in the NFL—especially at the quarterback position—that patching together a fantasy lineup has probably felt like attempting…		
Cowboys vs. Eagles Draws 27.1M Viewers, Most-Watched NFL Game of 2023 Season	Sunday's thrilling contest between the Dallas Cowboys and Philadelphia Eagles did massive numbers for Fox. According to Fox Sports public relations, the…		
Eagles' Jason Kelce to Feature in People Magazine's 2023 'Sexiest Man Alive' Edition	Philadelphia Eagles center Jason Kelce will be featured in People magazine's upcoming Sexiest Man Alive issue. People revealed six men, including Kelce, who…		
NHL Style Rankings: B's, Canadiens Continue Rivalry off Ice; A Legend Goes Shirtless	Remember two weeks ago, during the first installment of the third season of the OG NHL Style Rankings, when I said the guys were off to a slow fashion start…		
Fantasy Football Big Board: Complete 2023 PPR Player Rankings for Week 9	"It's Week 9 of the 2023 fantasy football campaign. We're past the halfway point, but not quite at the stretch run. Call it ""last chance"" time. Sure, there are…"		
Fantasy Football Big Board: Complete 2023 PPR Player Rankings for Week 8	Well folks, we're halfway home. Seven weeks into the 2023 fantasy football season, we've hit the midway point. It's a half-season that has gone very…		
Patrick Mahomes, Travis Kelce Excite Fans as Chiefs Beat Justin Herbert, Chargers	The Kansas City Chiefs earned their sixth straight win Sunday thanks to historic outings by two of the team's star players. Quarterback Patrick Mahomes topped…		
Taylor Swift's Rio de Janeiro tour scarred by deaths, muggings, heat-related illnesses	The deaths of two people, heat-related illnesses and other misfortunes have left legions of Taylor Swift fans angry and disappointed in the three-day Rio de Janeiro leg of the pop superstar’s Eras Tour		
Kelce Bowl: Chiefs' Travis, Eagles' Jason the center of attention in a Super Bowl rematch	You can’t go anywhere these days without hearing or seeing something that has to do with Eagles center Travis Kelce and his younger brother and Chiefs tight end Travis Kelce		
What to stream this week: 'Oppenheimer,' Adam Sandler as a lizard and celebs dance to Taylor Swift	This week’s new entertainment releases include Adam Sandler playing a 74-year-old elementary class lizard in the latest Netflix animation offering “Leo” and “Oppenheimer” finally arriving on home screens		
Taylor Swift fan dies before 'The Eras Tour' concert in Rio de Janeiro, Brazil	Taylor Swift fan dies before 'The Eras Tour' concert in Rio de Janeiro, Brazilgo.com		
'A noisy rock 'n' roll': How growing interest in Formula One is felt across the music world	Beyond the engineering, the athleticism, the speed, the luxury, fans love the sound of Formula One		
2024 Grammy nomination snubs and surprises: No K-pop, little country and regional Mexican music	With new categories, “Barbie” and SZA — there’s a lot to discuss regarding the 2024 Grammy Award nominations		
Partial list of nominees for the 66th Grammy Awards	The nominees for next year's Grammy Awards have been announced		
Movie Review: Nicolas Cage finds fame to be highly overrated in chillingly funny ‘Dream Scenario’	Nicolas Cage, perhaps best known for his onscreen volatility, takes a fascinating swerve to play a mundane, schlubby, balding professor at nowhere famous in Kristoffer Borgli's “Dream Scenario.”		
Court arguments begin in effort to bar Trump from presidential ballot under 'insurrection' clause	Court arguments are beginning in the effort to bar former President Donald Trump from running for his old job again		
From country to pop, 2014 nostalgia to 2023 reality — it's time for Taylor Swift's '1989'	Taylor Swift’s reimagined “1989” is here, the album that ushered in the first Peak Swift era — revisited at the height of her massive pop culture dominance		
Country musician Megan Moroney says she writes sad songs for sad people. It's making her a star.	Not so long before her platinum single “Tennessee Orange” became inescapable on country radio, Megan Moroney was attending the University of Georgia		
Chiefs' Travis Kelce has been taking his play to a new level with Taylor Swift in the house	Kansas City Chiefs tight end Travis Kelce has been taking his play to a new level whenever Taylor Swift is in the house		
What to stream this week: '1989 (Taylor’s Version),' Emily Blunt and 'Five Nights at Freddy’s'	This week’s new entertainment releases include Taylor Swift's “1989 (Taylor’s Version),” a glossy look at opioid addiction with the movie “Pain Hustlers” starring Emily Blunt, Chris Evans and Andy Garcia, and the streaming horror flick “Five Nights at ...		
"Swift bests Scorsese at box office, but 'Killers of the Flower Moon"" opens strongly"	In a movie match-up almost as unlikely as “Barbie” and “Oppenheimer,” Martin Scorsese took on Taylor Swift in cinemas over the weekend		
NFL Week 7 recap: Bill Belichick gets 300th regular-season win; Hurts rebounds to lift Eagles over Dolphins	Mac Jones threw a 1-yard touchdown pass to Mike Gesicki with 12 seconds remaining to lift the New England Patriots to a 29-25 win over the Buffalo Bills on Sunday, making Bill Belichick the third coach in NFL history with…		
Restored iPod models are selling out at retailers after only a year of being discontinued	Urban Outfitters is selling restored fifth generation iPods to Gen Z – and they're selling like hotcakes.		
Brazil has recorded its hottest temperature ever, breaking 2005 record	Brazil recorded its hottest-ever temperature on Sunday, as thermometers in the small city of Araçuaí hit 112.6 Fahrenheit.		
Eagles troll Chiefs with Taylor Swift reference after big win	"The team posted a picture of a green friendship bracelet that read ""Eagles win"" on Instagram​ following their 21-17 victory on Monday."		
Taylor Swift's parents to meet Travis and Jason Kelce's for first time at Eagles-Chiefs game: report	Taylor Swift's parents to meet Travis and Jason Kelce's for first time at Eagles-Chiefs game: reportcbsnews.com		
How to watch tonight's San Francisco 49ers vs. Minnesota Vikings game on Monday Night Football	The Vikings will try for a Minnesota Miracle to score their first win over the San Francisco 49ers since 2018.		
How to watch today's Atlanta Falcons vs. Tampa Bay Buccaneers game: Livestream options, Week 7 schedule, more	The Tampa Bay Buccaneers look to bounce back in a Week 7 divisional matchup against the Atlanta Falcons.		
How to watch today's Pittsburgh Steelers vs. Los Angeles Rams game	Aaron Donald and the LA Rams face Kenny Pickett and the Pittsburgh Steelers today. Here's how to watch.		
NFC showdown: How to watch today's Arizona Cardinals vs. Seattle Seahawks game	It's going to be tough for the Arizona Cardinals to beat the Seattle Seahawks at home, but this Cardinals squad is full of surpises.		
How to watch today's Miami Dolphins vs. Philadelphia Eagles game: Livestream options, kickoff time	Two 5-1 teams face off for the game of Week 7 when the Miami Dolphins hit the road vs the Philadelphia Eagles.		
How to watch today's Cleveland Browns vs. Indianapolis Colts game: Kickoff time, livestream options, more	Deshaun Watson is expected to return for the Cleveland Browns' Week 7 game against the Indianapolis Colts.		
How to watch today's Buffalo Bills vs. New England Patriots game: Livestream options, kickoff time, more	The Bills are 6-1 against the Tom Brady-less Patriots, but over confidence could send the Bills home with a loss.		
Jason Kelce Knew Travis Was 'Beating Himself Up Pretty Good' After MNF Loss	The Eagles star got his first NFL win over his younger brother, who struggled through a frustrating game for the Chiefs.		
Kellyanne Conway's Daughter Backs Campaign to Oust Harry Jowsey From 'DWTS'	"Claudia Conway showed support for a campaign to see Jowsey eliminated from ""DWTS""—and the reason is all about Taylor Swift."		
Video of Patrick Mahomes, Wife Brittany's Kiss Goes Viral	"""She made him sleep on the sofa after the game,"" joked one football fan."		
How Taylor Swift and Travis Kelce's First Meeting Unfolded	"The Kansas City Chiefs tight end revealed he had ""someone playing Cupid"" on Taylor Swift's team."		
Jason Kelce, D'Andre Swift Execute Elite 'Swift Kelce' Troll Before MNF	Jason Kelce and D'Andre Swift walked out of the tunnel together before the Eagles took on the Chiefs on Monday.		
Travis Kelce Crashed ESPN's Monday Night Football Set (and Had Mic Issues)	The Kansas City Chiefs star seemed excited and ready for the Super Bowl rematch against the Eagles and his brother Jason.		
'Kelce Bowl:' 5 Facts About Jason, Travis Kelce as Eagles, Chiefs Face Off	"The Chiefs (7-2) host the Eagles (8-1) at 8:15 p.m. ET in a prime-time ""Monday Night Football"" showdown and Super Bowl rematch."		
Caesars Sportsbook Promo Code for MNF: Use NEWSWK1000 to Get $1,000 Bet	Caesars Sportsbook promo code NEWSWK1000 will unlock a $1,000 first bet for Eagles-Chiefs on Monday Night Football.		
Here's the Real Threat from AI Right Now (Just Ask My Son)	A content farm used AI to write the author's biography. Most of it was wrong.		
Jason Kelce Came Into Her Hot Dog Restaurant and 'Tried To Roast the Queen'	The Eagles center made a good impression on employees at Wiener's Circle, including resident trash-talker Poochie Rollins.		
Patrick Mahomes Joining ESPN's ManningCast After Failed 'Audition' For Show	The Kansas City Chiefs quarterback was featured in an Omaha Productions skit with Peyton and Eli Manning over the summer.		
Josh Dobbs Isn't a Just Viral Story, He's a Valuable Lesson for Sports Fans	While the Vikings quarterback has become the talk of the NFL over the past couple of weeks, he's more than just a feel-good story.		
Biden Gets Bad Economic News as Polls Spell Disaster	Consumers expect inflation to be high in 2024 just as President Joe Biden will be seeking re-election.		
Brittany Mahomes' Skims Ad Sparks Backlash	Brittany and Patrick Mahomes star in a campaign for Kim Kardashian's Skims clothes brand ahead of the holidays.		
Harry Styles Made a Big Change and Fans Are Shaken	Fans have taken to X, formerly known as Twitter, to share their heartbreak over the singer's shock decision.		
Jason Kelce (Not Travis) Named One of People's Sexist Men Alive	"The Philadelphia Eagles center told the publication he and his family are ""just trying to have fun"" as his fame soars."		
Donald Trump's January 6 Choir Comes Back To Haunt Him	Special prosecutor Jack Smith says that Trump's use of recordings of the choir at campaign rallies shows that he is glorifying the Capitol riot.		
Rob Schneider Under Fire Over Travis Kelce Comment	"""Not true just more lies,"" one person wrote, while another added: ""Not sure Travis knows who Rob even is."""		
Dolly the Disruptor: The Queen of Country's Barrier-Breaking Milestones	A timeline of Dolly Parton's iconic career—when she pioneered the pop-country crossover, paved the way for female artists and showed the world compassion wins.		
Exclusive: Dolly Parton on Rock, Rhinestones and Her Genre-Busting Career	"The queen of country talks to Newsweek about her new rock album, iconic style and music industry breakthroughs: 'I just do what my heart tells me."""		
Mike Johnson Has Already Made His First Mistake	Speaker Johnson has caused controversy by demanding an IRS funding cut in return for aid to Israel.		
Americans Are Earning More Even as They Complain About the Economy	Wages are rising, but Americans still feel the economy is headed in the wrong direction.		
Bills QB Josh Allen Probably Did Not Call a 'Taylor Swift' Audible	"Astute fans watching the Thursday Night Football broadcast heard Josh Allen call an audible, but did he say ""Taylor Swift"" or ""J.R. Smith?"""		
Travis Kelce Goes Viral for Bizarre Game Behavior	A video of Travis Kelce barking at a Los Angeles Chargers player during the game on Sunday has gone viral, with fans divided over the footage.		
Lamar Jackson Leads the Best Performers of Week 7 in the NFL	Quarterbacks took the stage again this week, leading their teams to victory.		
NFL Week 7 Winners and Losers: Eagles Slow Down Dolphins Offense in SNF Win	The Eagles managed to mostly contain the top-ranked Dolphins offense in a 31-17 win on Sunday Night Football.		
The KC Chiefs Have a Ready-Made Insurance Policy for Nick Bolton's Injury	While seeing starting linebacker Nick Bolton go down injured isn't ideal, the Kansas City Chiefs are well positioned to cope with his absence.		
Travis Kelce Salary: How Much Does the Chiefs Tight End Make?	Travis Kelce is sitting squarely in the center of the pop-culture spotlight. Have you ever wondered about his earning power with the Chiefs?		
TIME’s Top 100 Photos of 2023	Did you see this photo??*link*Wow.Omg!! Follow this exchange with a dynamic discussion, hit repeat, and you have a pretty accurate snapshot of the TIME photo department’s typical Slack conversations. Even though we collectively scroll through thousands of pho…		
Pink to kick off 2024 UK tour in Cardiff	The singer says she's looking forward to helping celebrate 25 years of the Principality Stadium.		
Brazil records its hottest ever temperature	The town of Araçuaí in the country's southeast hit a high of 44.8C (112.6F) on Sunday.		
Robbie Williams fan dies after fall at Sydney concert	The woman in her 70s slipped and fell down six rows of seats, suffering serious head injuries.		
Taylor Swift appears out of breath at Rio concert	Video showed the singer gasping for air in between songs during her performance in the stifling heat.		
Taylor Swift postpones Rio de Janeiro concert after death of fan	The US pop star says she is putting safety first after temperatures in the Brazilian city reached 39.1C.		
Taylor Swift 'devastated' as fan dies before show	The pop star gave out water bottles to fans during the concert in Brazil, amid sweltering heat.		
The Beatles' hits albums denied number one (again)	The Fab Four's hopes of correcting a historic blip in their chart record are dashed by Taylor Swift.		
Taylor Swift gets 'heavenly' welcome from Christ the Redeemer	The famous statue in Rio de Janeiro is illuminated as the global pop sensation arrives on her Eras tour.		
NFL star Jason Kelce tops iTunes chart with new Christmas hit	The NFL star joined his brother Travis Kelce to reimagine the Christmas hit Fairytale of New York.		
Cardiff City Stadium to host Welsh rugby's Judgement Day	Welsh rugby's Judgement Day derby URC double-header will be held at Cardiff City Stadium on 1 June.		
Harry Styles haircut reveal in Vogue lights up debate	The former One Direction star confirms his famous mop top is History - and fans have strong thoughts.		
Aria Awards: Troye Sivan wins big and Kylie Minogue wins with Padam Padam	Kylie Minogue wins with Padam Padam at the Aria Awards, whilst Troye Sivan takes home four awards.		
The Las Vegas GP - a plan 40 years in the making	F1 is going all out to make an impression in Las Vegas, but what's the background to what promises to be an iconic race?		
Taylor Swift adds two more Wembley dates to Eras tour, equalling Take That record	The pop star adds two extra nights to her Eras tour, and matches a Wembley record set by Take That.		
The Marvels: Superhero movie bombs with lowest MCU box office debut	"""This opening is an unprecedented Marvel box office collapse,"" says box office analyst David A Gross."		
The Beatles top singles chart 60 years after their first hit	"Sir Paul McCartney says their final song Now and Then reaching the top spot has ""blown my socks off!"""		
Grammy Awards 2024: The main nominees	Taylor Swift, Olivia Rodrigo, Miley Cyrus and SZA are among the nominees at the 2024 ceremony.		
Grammy Awards 2023: Taylor Swift breaks nomination record	Swift has become the first songwriter to receive seven song of the year nominations.		
TfW travel: New rail line for major Cardiff events axed	Public money has been lost on the project, which would have improved travel to major Cardiff events.		
Chiefs & Dolphins set for 'electric' Germany clash	The NFL returns to Germany with a mouth-watering match-up between defending champions the Kansas City Chiefs and the in-form Miami Dolphins.		
Taylor Swift’s 1989 re-recording scores record-breaking UK chart debut	A re-recorded version of Swift’s 2014 pop opus more than doubles the first-week sales of the original.		
Jung Kook's Golden: BTS star crowned 'pop king' by critics thanks to solo album	"Critics say the star's solo debut is ""pop bliss"" and he has ""punched his ticket to pop superstardom""."		
Singer Weyes Blood: I feel like I've lived a million lives	"The ethereal singer-songwriter and ""pagan time travel tourist"" on making music for a changing world."		
Taylor Swift and Barbie take over this Halloween	From Utah to Massachusetts, pop culture references have turned this year’s spooky season pink.		
FNaF movie: Halloween box office records broken by Fazbear gang	Critics weren't keen on the game adaptation, but fans helped the film rack up monster ticket sales.		
Taylor Swift not buying Notts County, football club confirms	"The owners of the League Two outfit say they are sorry to ""disappoint the Swifties in our fanbase""."		
Taylor Swift: Artist paints the star on giant Halloween pumpkin	It took Ohio-based Jeanette Paras 10 hours to create the artwork.		
Taylor Swift's 1989: Why has she re-recorded it and what's new on Taylor's Version?	How does Taylor's Version of the hit album compare to the original, and why has she re-recorded it?		
Glastonbury Festival: Emily Eavis lines up 'really big' US artist for 2024	Organiser Emily Eavis says one 2024 headliner is almost in the bag, and she'd love Madonna to play.		
Johnny Cash's 'Blank Space' Is Why AI Can't Have Nice Things	With covers of Taylor Swift and “Barbie Girl” going viral, Johnny Cash is suddenly the voice of AI. The choice is telling.		
Taylor Swift and Beyoncé Are Resurrecting the American Movie Theater	This week, as “Swifties of the Flower Moon” took over social media, Swift trounced Martin Scorsese at the US box office. Beyoncé’s tour film is coming later this fall. Cinema is back, baby!		
Fan dies at Taylor Swift Eras Tour concert in Brazil with record heat	A 23-year-old woman succumbed to heat as Taylor Swift brought her Eras Tour to a concert venue in Rio de Janeiro.		
The 31 best things to do in D.C. this weekend and next week	Get in the holiday spirit with holiday markets, light displays and Scrooge; celebrate Community Day at Planet Word; or browse works by hundreds of artists.		
Fake celebrity statements and videos on Israel-Hamas war — and other news literacy lessons	From the non-partisan News Literacy Project.		
Sorry, Jane Austen, but Mr. Darcy is actually the worst	According to English professor Rachel Feder, the romantic hero of ‘Pride and Prejudice’ has set us up to love men who treat us like dirt.		
‘Fingernails’: A form of cinematic torture	Jessie Buckley, Jeremy Allen White and Riz Ahmed star in a silly, sci-fi story of a love triangle.		
12 can’t-miss concerts in the D.C. area this November	Ice Spice and Doja Cat at Capital One Arena; Benny the Butcher at Howard Theatre; Liz Phair at the Anthem.		
Third quarter GDP shows U.S. economy grew at a blockbuster 4.9 percent pace	Third quarter GDP shows U.S. economy grew at a blockbuster 4.9 percent pacewashingtonpost.com		
Hunger Games’ director feels bad about his 45-minute song pitch for Olivia Rodrigo	The Ballad of Songbirds & Snakes director Francis Lawrence explains his 45-minute rant to Olivia Rodrigo. “Can’t Catch Me Now” is streaming now.		
Concert movies are the future of pop music fandom	Taylor Swift, BTS, and Beyoncé’s concert movies level the field for fans. Once considered secondary to live shows, filmed concerts are now essential to fandom.		
Taylor Swift was the soundtrack to my Killers of the Flower Moon screening	Did you hear Taylor Swift: The Eras Tour while trying to watch Martin Scorsese’s latest movie? You aren’t alone.		
Taylor Swift’s Rio Tour Marred by Deaths, Muggings and a Dangerous Heat Wave	RIO DE JANEIRO — The deaths of two people, muggings and a dangerous heat wave left legions of Taylor Swift’s Brazilian fans angry and disappointed in the three-day Rio de Janeiro leg of the pop superstar’s Eras Tour, which concludes Monday night.		
Joe Biden Makes Bizarre Joke at Turkey Pardoning, Confuses Taylor Swift and Britney Spears	President Joe Biden made a bizarre, confusing joke during this year's annual turkey pardoning ceremony at the White House, seemingly referencing Taylor Swift's sweltering concert in Brazil, which tragically resulted in the death of one fan, but also mentionin…		
Rio de Janeiro Officials Project Taylor Swift Welcome onto Famed 'Christ the Redeemer' Statue	Officials in Rio de Janeiro were so excited about pop star Taylor Swift's imminent concerts in Brazil that they electronically projected a Swifty-themed robe onto its famed Christ the Redeemer statue that overlooks the glittering city.		
Taylor Swift Fan Dies at Rio Concert as Fans Complain About High Temperatures and Lack of Water	RIO DE JANEIRO (AP) — A 23-year-old Taylor Swift fan died at the singer’s Eras Tour concert in Rio de Janeiro Friday night, according to a statement from the show’s organizers in Brazil.		
Taylor Swift Promoted Left-Wing Voter Registration Organization While Remaining Silent on Hamas' Massacre of Israelis	Mega pop star Taylor Swift used her massive social media following to promote a left-wing voter registration organization on election day. But the singer continues to remain silent on Hamas' massacre of Israelis more than a month after the October 7 slaughter.		
Taylor Swift Calls on Fans to Hit the Polls Ahead of Major Elections in Several States	Pop star Taylor Swift, the jet-setting climate change activist who endorses Democrats, attacks Republicans, and performs for Communist human rights abusing-China’s Singles Day, took to social media on Tuesday to encourage her fans in certain states to vote on…		
VIDEO: Broncos Troll Chiefs, Travis Kelce by Playing Taylor Swift Music After Upset Win	The Broncos trolled the Chiefs by playing Taylor Swift music after their upset win over Kansas City on Sunday.		
'We Want More Football!!!': Rob Gronkowski Says Networks Overdoing Taylor Swift Coverage	Former Super Bowl champ Rob Gronkowski think that broadcast network's should focus less on Taylor Swift and more on the players on the field.		
Google sues people who “weaponized” DMCA to remove rivals’ search results	Google says DMCA fraudsters filed copyright takedown notices for 600,000+ URLs.		
A remote worker explains why she stands by the controversial practice of working from movie theaters	A viral video of a remote worker using a movie theater as an office has divided viewers. But she stands by her take that it's a great place to work from.		
Naming a species after a celebrity may do more harm than good	Many species were named in honor of famous people and celebrities. But species names are difficult to change and may lead to nomenclatural regret.		
Far-right hosts are blaming the GOP's big election losses on Taylor Swift	Right-wing activist Jack Posobiec and commentator Charlie Kirk both blamed Taylor Swift's political power for electoral losses.		
Taylor Swift achieves billionaire status amid monumental Eras tour	According to a Bloomberg News Analysis published Thursday, Taylor Swift's net worth is $1.1 billion.		
Taylor Swift: Friend Cara Delevingne says Swift and Travis Kelce’s relationship is ‘very different’	Taylor Swift: Friend Cara Delevingne says Swift and Travis Kelce’s relationship is ‘very different’cnn.com		
Taylor Swift set to perform rescheduled Rio show after deadly heat | CNN	Taylor Swift will wrap up her “Eras Tour” concerts in Rio de Janeiro, Brazil on Monday, following a weekend of shows beset by dire heat and tragedy.		
Travis Kelce is ready to talk about dating Taylor Swift | CNN	There was a time when Travis Kelce wasn’t interested in talking about his personal life, but no more.		
The enduring allure of Louboutin’s red soles	In the 30 years since the inception of the brand’s red sole, Louboutin has perhaps done more than any other to transform a piece of footwear into an objet d’art.		
Taylor Swift postpones Eras Tour concert in Rio de Janeiro due to heat	Taylor Swift announced that her concert scheduled for Saturday in Rio de Janeiro, Brazil has been postponed due to high temperatures.		
Taylor Swift mourns fan who died before concert in Brazil | CNN	Taylor Swift fan died Friday night before the Eras Tour show in Rio De Janeiro, Brazil the singer said on Instagram.		
5 things to know for Nov. 17: Trump agenda, Israel, Safe schools, George Santos, Apple | CNN	5 things to know for Nov. 17: Trump agenda, Israel, Safe schools, George Santos, Apple | CNNcnn.com		
Travis Kelce apologizes to Taylor Swift’s dad | CNN	Remember when Travis Kelce said he was going to stick to talking about football and not his private life? Good thing for the Swifties it looks like he didn’t mean it.		
Taylor Swift ‘Dancing With the Stars’	Taylor Swift ‘Dancing With the Stars’cnn.com		
Travis Kelce sings on brother’s Christmas song | CNN	Travis Kelce sings on brother’s Christmas song | CNNcnn.com		
Taylor Swift concert postponement prompts airline to waive change fee | CNN	LATAM Airlines waived its change fees for customers who wanted to extend their stay in Buenos Aires, Argentina, after Taylor Swift postponed her concert there.		
Taylor Swift changes lyrics to ‘Karma’ in nod to ‘guy on the Chiefs’ Travis Kelce | CNN	Taylor Swift winked at her romance with Kansas City Chiefs’ tight end Travis Kelce during her “Eras Tour” concert in Buenos Aires, Argentina on Saturday when she changed the lyrics to a line in her hit song “Karma,” and Kelce was in the audience to catch it.		
Taylor Swift reschedules ‘Eras Tour’ performance	Taylor Swift reschedules ‘Eras Tour’ performancecnn.com		
Grammy nominations 2024: See the full list of nominees | CNN	Nominations for the 2024 Grammy Awards will be revealed on Friday morning.		
Americans say the economy stinks. But they’re spending like it’s great | CNN Business	There’s a conundrum that economists and political strategists have been chewing on for more than a year: The economy is good, but Americans say it’s lousy.		
5 things to know for Nov. 7: Trump trial, Israel, Presidential debate, Actors strike, Ukraine | CNN	5 things to know for Nov. 7: Trump trial, Israel, Presidential debate, Actors strike, Ukraine | CNNcnn.com		
Taylor Swift reporter hired at Gannett after viral job listing | CNN	Consider journalist Bryan West the “lucky one,” because he’s The Tennessean and USA Today network’s new Taylor Swift Reporter.		
Taylor Swift adds Brittany Mahomes to her squad | CNN	Taylor Swift adds Brittany Mahomes to her squad | CNNcnn.com		
Taylor Swift’s ‘1989 (Taylor’s Version)’ is her 13th album to hit No. 1 on Billboard charts	Taylor Swift continues to break records in her whirlwind year, with “1989 (Taylor’s Version)” hitting No. 1 on the Billboard 200 album charts. It’s the singer’s 13th No. 1 album.		
Taylor Swift and Beyoncé concert tours deliver record-breaking earnings for Live Nation	Live Nation has Taylor Swift and Beyoncé to thank for propelling the live concerts organizer to its strongest quarterly results to date.		
Ice Spice turns heads in Betty Boop Halloween costume	Ice Spice has shown the world what she’s working with in her latest Halloween costume — and she wasn’t afraid to let it all hang out.		
5 things to know for Oct. 27: Maine shootings, Israel, US strikes, Hurricane Otis, Presidential race | CNN	5 things to know for Oct. 27: Maine shootings, Israel, US strikes, Hurricane Otis, Presidential race | CNNcnn.com		
Taylor Swift releases ‘1989 (Taylor’s Version)’ | CNN	Straight out of your “wildest dreams,” Taylor Swift just dropped “1989 (Taylor’s Version).”		
Taylor Swift is now a billionaire, Bloomberg says | CNN Business	Taylor Swift has another accolade to add to her already impressive resume this year: America’s favorite pop star is now a billionaire, according to a Bloomberg analysis.		
5 things to know for Oct. 23: Israel, House speaker, Synagogue leader, Police shooting, Student loans	5 things to know for Oct. 23: Israel, House speaker, Synagogue leader, Police shooting, Student loanscnn.com		
Taylor Swift is still in her (Chiefs) Red era with latest appearance supporting Travis Kelce at football game | CNN	In a surprise to absolutely nobody, Taylor Swift was back in Kansas City on Sunday to support Travis Kelce at his football game.		
Why the latest temperature check on climate change is still terrifying	The United Nations Environment Programme (UNEP) released its latest estimates for future global warming ahead of climate change negotiations in Dubai.		
Do Pixel 8 AI-edited photos have to be labeled as synthetic content on YouTube? YouTube is still figuring it out.	The new Pixel 8 can swap facial expressions in photos using AI. YouTube’s new rules require labels on AI-generated content. What happens next?		
Taylor Swift fans used record amounts of data during the Eras Tour in North America	A staggering 29 terabytes of glitter moved through AT&T’s network during her stop in Arlington, Texas, and Swifties set data usage records almost everywhere else.		
Scarlett Johansson hits AI app with legal action for cloning her voice in an ad	Scarlett Johansson is taking legal action against an AI app developer for using her likeness in an online ad without her consent.		
Harvard professor Lawrence Lessig on why AI and social media are causing a free speech crisis for the internet	The internet policy legend is as worried as you’d think about AI and TikTok.		
'The View' hosts see red flags in Travis Kelce's Taylor Swift interview	'The View' hosts discussed the 'red flags' they saw in Travis Kelce's recent interview about dating Taylor Swift, and called the NFL star a 'palate cleanser' for the singer: 'What is he hiding?'		
Travis Kelce shares how Taylor Swift romance began	Travis Kelce shared details about how his love story with Taylor Swift began, revealing he had some help from her family members.		
Joy Behar doesn’t want Taylor Swift stuck with ‘idiot’ Travis Kelce	'The View' host Joy Behar doesn't want Taylor Swift to be 'stuck with this idiot' Travis Kelce after several of his posts making disparaging comments about women resurfaced online: 'He’s illiterate.'		
'The Marvels' has MCU's worst box office opening ever	'The Marvels' went lower, nearer, and slower with MCU's worst box office opening ever, grossing $47 million.		
Taylor Swift changes 'Karma' lyric for Travis Kelce at Eras concert	Taylor Swift shouted out Travis Kelce in a 'Karma' lyric change at a show in Argentina: 'Karma is the guy on the Chiefs, coming straight home to me.'		
'Mean Girls' movie musical trailer brings back the Plastics	The first-look trailer at the 'Mean Girls' movie musical sees the likes of Regina George, Cady Heron, Janis Ian, and more — now with more music.		
See NSYNC's troll transformation in 'Trolls Band Together'	The members of NSYNC are getting a sparkly troll transformation in 'Trolls Band Together' — here's your first look.		
'Big Brother' host Julie Chen Moonves teases 'Legends' season	'Big Brother' host Julie Chen Moonves teases that a possible winter 'Legends' season or celebrity edition could be in the works.		
'The Voice' adds Wynonna Judd as Mega Mentor for season 24	Country icon Wynonna Judd is joining 'The Voice' as a Mega Mentor for season 24.		
Five Nights at Freddy's debuts to $78 million	'Five Nights at Freddy's' tops the weekend box office with $78M, the biggest opening for a horror movie in 2023.		
'Taylor Swift: The Eras Tour' tops domestic box office for 2nd week	'Killers of the Flower Moon' eclipsed by 'Taylor Swift: The Eras Tour' domestically, but debuts at No. 1 globally.		
