Wrongful death suit filed against top NBA pick Brandon Miller	The mother of a woman killed near the University of Alabama in January has filed a wrongful death lawsuit in federal court against Charlotte Hornets rookie Brandon Miller and two other men.	unrelated 
Nolte: Taylor Swift Humiliates Hollywood Again -- Trounces Leo’s ‘Flower Moon’	Nolte: "Taylor Swift: The Eras Tour" grossed another $32 million, humiliating Leonardo Di Caprio’s "Killers of the Flower Moon," which debuted to just $22 million.	music
Funflation': Most Americans Cutting Back on Amusement Parks, Live Entertainment as Prices Soar Under Biden	Nearly 60 percent of Americans are cutting back on spending on live entertainment -- including amusement parks, rock concerts, and the performing arts -- as prices continue to soar through the roof, according to a new survey of 1,000 individuals conducted by …	unrelated
Gwyneth Paltrow intends to 'literally disappear'; Taylor Swift 'protected and cherished' by Travis Kelce	The Fox News Entertainment newsletter brings you the latest Hollywood headlines, celebrity interviews and stories from Los Angeles and beyond.	relationship
Ben Simmons has his health and old job back. Now Nets need to see his old game	Reinstalled as point guard, Ben Simmons has been moving quickly and decisively again in the preseason after playing just 42 games the last two seasons. It gives the Nets hope.	unrelated
Chiefs’ Travis Kelce loses 'friendly wager,' dons Iowa State mascot headgear: 'Go Cyclones'	Kansas City Chiefs All-Pro tight end Travis Kelce attended his Friday press conference wearing the headgear of the Iowa State mascot after losing a "friendly wager"	unrelated
Boomers were right! 5 things about adulting no one wants you to know	Every generation thinks it's cornered the market on brains, but you have to know what to do with them. Which is why wisdom matter. So let me offer some.	unrelated
A movie theater staffer describes what it was like to work Taylor Swift's Eras Tour film premiere, which was so loud it blew out 2 amps	Taylor Swift's Eras Tour film was so loud it blew the sound system in one theater.	movie
Taylor Swift and Travis Kelce, Gwen Stefani and Blake Shelton bring the romance: PHOTOS	Taylor Swift and Travis Kelce were spotted together at a "Saturday Night Live" after-party, and Blake Shelton supported Gwen Stefani at her Hollywood Walk of Fame ceremony.	relationship
Sixers will start regular season without James Harden 'unless something changes'	The Philadelphia 76ers finished their entire preseason schedule without James Harden playing for them.	unrelated
Despite three red-zone fumbles, Falcons still beat Bucs to grab first place	Both teams struggled near the goal line, but Atlanta hit a field goal as time expired to beat the Bucs and move into first place in the NFC South.	unrelated
Taylor Swift sports Travis Kelce's football jersey number on friendship bracelet at Chiefs game	Taylor Swift showed NFL fans how to support a player by wearing Travis Kelce's football jersey number on a friendship bracelet while watching Chiefs game.	NFL
Travis Kelce's big day with Taylor Swift in attendance helps Chiefs to huge win over Chargers	Travis Kelce had a dominant performance with his rumored girlfriend, Taylor Swift, in the building during the Kansas City Chiefs' big win on Sunday.	relationship
11 photos of Taylor Swift going through all the emotions watching Travis Kelce at the Chiefs game	Waving to fans, celebrating and more for Taylor Swift in her return to Arrowhead Stadium.	relationship
Browns edge Myles Garrett dominates in win over Colts: 'Man, 95 is a problem'	Myles Garrett's Sunday: nine tackles, two sacks, two forced fumbles, a pass breakup and a blocked field goal. Oh, and the Browns won 39-38.	unrelated
Taylor Swift, Brittany Mahomes show off new handshakes amid monster half for Patrick Mahomes, Travis Kelce	Taylor Swift and Brittany Mahomes, the wife of star quarterback Patrick Mahomes, showcased their new touchdown handshake as their budding friendship continues.	miscellaneous 
NFL Week 7 top viral moments: LeBron James, Taylor Swift celebrate National Tight Ends Day	There was plenty to buzz about on social media during an action-packed NFL slate. Check out the moments that had the internet talking here!	NFL
Taylor Swift returns to Arrowhead stadium to cheer on Travis Kelce	This is the fifth time Swift has been seen cheering on Kansas Chiefs tight end Travis Kelce and the defending Super Bowl champions.	relationship
Jay Glazer: Cardinals want to build around Kyler Murray, not trade him	NFL insider Jay Glazer joined David Helman to discuss Kyler Murray trade rumors on another segment of "Ask Glazer" on the "NFL on FOX Pod"	unrelated
Taylor Swift: The Eras Tour' tops domestic box office for 2nd week	Killers of the Flower Moon' eclipsed by 'Taylor Swift: The Eras Tour' domestically, but debuts at No. 1 globally.	music
Video: Taylor Swift, Brittany Mahomes Celebrate With Handshake at Chargers vs. Chiefs	Kansas City Chiefs wide receiver Marquez Valdes-Scantling wasn't the only one excited to see Patrick Mahomes throw his first deep touchdown pass of the season…	miscellaneous 
CBS actually broke out a hilarious graphic about Travis Kelce's stats with Taylor Swift in attendance	Incredible work. No notes.	relationship 
NFL Week 7 top viral moments: LeBron James loves big days from Myles Garrett, Lamar Jackson	There was plenty to buzz about on social media during an action-packed NFL slate. Check out the moments that had the internet talking here!	unrelated
Browns' PJ Walker leads controversial game-winning drive to defeat Colts on the road	Cleveland Browns quarterback P.J. Walker, playing for the injured Deshaun Watson, led a controversial game-winning drive over the Indianapolis Colts on Sunday.	unrelated
Taylor Swift sports new friendship bracelet with beau Travis Kelce’s jersey number on it at Chiefs game	This is basically the 2023 version of wearing a letter jacket, right?	relationship
Taylor Swift and Brittany Mahomes shared a silly pregame dance in the duo’s return to KC	Taylor Swift and Brittany Mahomes had some adorable fun in their return to Arrowhead Stadium.	miscellaneous 
Taylor Swift spotted at Chiefs-Chargers game at Arrowhead Stadium	Taylor Swift has touched down in Kansas City to attend the Chiefs' home game against the Chargers.	relationship
Taylor Swift is still in her (Chiefs) Red era with latest appearance supporting Travis Kelce at football game | CNN	In a surprise to absolutely nobody, Taylor Swift was back in Kansas City on Sunday to support Travis Kelce at his football game.	relationship
NFL Week 7 Top viral moments: LeBron James loves big days from Myles Garrett, Lamar Jackson	There was plenty to buzz about on social media during an action-packed NFL slate. Check out the moments that had the internet talking here!	unrelated
Taylor Swift takes in Chargers-Chiefs at Arrowhead in Week 7	Taylor Swift is back at Arrowhead Stadium for the second week in a row to watch the Los Angeles Chargers take on the Kansas City Chiefs.	relationship
Taylor Swift watches football with former NFL quarterback Bernie Kosar before attending Chiefs game	Taylor Swift is back at Arrowhead Stadium to catch her rumored beau Travis Kelce, but before attending the game, she watched the early games with Bernie Kosar.	NFL
Lamar Jackson Leads the Best Performers of Week 7 in the NFL	Quarterbacks took the stage again this week, leading their teams to victory.	unrelated/NFL
Taylor Swift was the soundtrack to my Killers of the Flower Moon screening	Did you hear Taylor Swift: The Eras Tour while trying to watch Martin Scorsese’s latest movie? You aren’t alone.	miscellaneous 
The Philadelphia Eagles' signature 'tush push' is effectively driving its critics mad	Philadelphia and Jalen Hurts beat the Miami Dolphins on Sunday. The Eagles' only crime with its "brotherly shove" is making football fourth downs less dramatic.	unrelated
Mom's creepy-cool Taylor Swift Halloween display goes viral on TikTok	A Wisconsin mom has gone viral after she shared her creative Taylor Swift Eras Tour Halloween decor with fellow "Swifties" on TikTok, reaching millions of people.	viral_moment
Travis Kelce dazzled in Week 7. Is he 'showing off' for Taylor Swift?	Travis Kelce had a huge 179-yard performance in Week 7, making some NFL fans wonder if he's "showing off" for Taylor Swift. And maybe that's a good thing.	NFL
Taylor Swift kisses Travis Kelce on the cheek in Instagram photo	Taylor Swift and Travis Kelce are getting just a little bit more cozy in a new snap that has fans buzzing.	viral_moment
Chiefs' Travis Kelce has been taking his play to a new level with Taylor Swift in the house	Kansas City Chiefs tight end Travis Kelce has been taking his play to a new level whenever Taylor Swift is in the house	relationship 
Taylor Swift kisses Travis Kelce following Kansas City Chiefs game	Taylor Swift and Travis Kelce's romance heats up as a new photo of the pop star kissing the NFL tight end's cheek surfaced after she attended Sunday's Kansas City Chiefs game.	NFL
NFL Week 7 Winners and Losers: Eagles Slow Down Dolphins Offense in SNF Win	The Eagles managed to mostly contain the top-ranked Dolphins offense in a 31-17 win on Sunday Night Football.	unrelated 
Travis Kelce trying to impress Taylor Swift is GREAT for Chiefs | What’s Wright?	The Kansas City Chiefs were able to take care of business against the Los Angeles Chargers, soundly defeating them at home in Arrowhead 31-17. So how do Patrick Mahomes’ Chiefs avoid complacency with that challenge out of the way? Nick Wright points to one fa…	miscellaneous 
Travis Kelce's dad says he's impressed by Taylor Swift after meeting pop star	Despite Travis Kelce joking that his father meeting Taylor Swift was "terrifying," Ed Kelce reportedly had a great first impression of the pop star.	miscellaneous 
Taylor Swift fans aren't going to be happy with Terry Bradshaw's Eras Tour lip sync theory	Taylor Swift fans might have some beef with Terry Bradshaw over this one.	miscellaneous 
Are you washing your jeans enough? — plus Kirk Cameron's powerful plea	The Fox News Lifestyle Newsletter brings you trending stories on family, travel, food, neighbors helping neighbors, pets, autos, military veterans, heroes, faith and American values.	unrelated
Taylor Swift secures Travis Kelce's dad's stamp of approval in glowing review: 'Very special'	Taylor Swift seemingly earned a stamp up of approval from new beau Travis Kelce's father. Ed Kelce shared insight into his relationship with the pop star in a new interview.	relationship
Taylor Swift Effect: Chiefs 5-0, 4-1 ATS since star began attending Travis Kelce games	Travis Kelce and the Chiefs are on fire since superstar Taylor Swift started attending games. Patrick Everson talked to a long-time bookmaker about Kelce's props and how Swift has impacted the betting markets.	miscellaneous 
Taylor Swift fans worry after she spends time with Jackson Mahomes, Britney Spears shares why she goes nude	The Fox News Entertainment newsletter brings you the latest Hollywood headlines, celebrity interviews and stories from Los Angeles and beyond.	miscellaneous 
What to Know About the Dolly Parton Event Hitting Theaters Soon	The first-listen event for Parton's new "Rockstar" album is set to land in theaters on November 15.	unrelated
Chiefs' Travis Kelce responds to Andy Reid's comments on the impact of Taylor Swift	Travis Kelce is thankful for coach Andy Reid's approval of the presence of Taylor Swift at Chiefs games: "You know you're doing something right."	miscellaneous 
Union Berlin are no longer an underdog fairytale, but they're worth rooting for	Union Berlin's players couldn't believe the support of their home fans as their losing streak stretched to nine games on Tuesday night. But that's what makes this club, and its supporters, so special.	unrelated
Rob Gronkowski's claim that Taylor Swift gets too much NFL airtime is overblown	Come on, Gronk. You're wrong about this one.	miscellaneous 
Connor Hellebuyck and his wife debut first of many Travis Kelce and Taylor Swift Halloween costumes this season	The Taylor Swift and Travis Kelce Halloween costumes are beginning to roll in.	miscellaneous 
Chiefs' Travis Kelce Will Have Feature on Jason Kelce, Eagles' 2nd Christmas Album	Travis Kelce starts dating Taylor Swift and all of a sudden the Kansas City Chiefs star embarks on a musical career. Travis and brother Jason announced…	relationship
Chiefs' Travis Kelce Addresses Viral Taylor Swift Stat Graphic from Chargers Game	Kansas City Chiefs star Travis Kelce is well aware of the difference in his performance this season when Taylor Swift is at his games as opposed to when she's…	viral_moment
Buccaneers vs. Bills live updates: Top moments from Thursday Night Football	Week 8 of the NFL season gets underway Thursday with the Bills playing host to the Buccaneers. Here are the top moments!	unrelated
Taylor Swift is now a billionaire, Bloomberg says | CNN Business	Taylor Swift has another accolade to add to her already impressive resume this year: America’s favorite pop star is now a billionaire, according to a Bloomberg analysis.	award
‘1989 (Taylor’s Version)’ is coming. Here’s what to know.	‘1989 (Taylor’s Version)’ features vault tracks: “Now That We Don’t Talk,” “Suburban Legends,” “Say Don’t Go,” “Is It Over Now?” and “‘Slut!’”	music
Trevor Lawrence to Trey Lance: Grading the 2021 quarterback class so far	Former NFL scout Bucky Brooks checks in on the quarterback class of 2021, grading the five first-round picks on their performances so far.	unrelated
Taylor Swift achieves billionaire status amid monumental Eras tour	According to a Bloomberg News Analysis published Thursday, Taylor Swift's net worth is $1.1 billion.	miscellaneous 
FOX Super 6 NFL contest: Chris 'The Bear' Fallica's Week 8 picks	The FOX Super 6 NFL contest has already given away $70,000. Will you be the next winner? If you need a little help with this week's questions, Chris "The Bear" Fallica has you covered!	unrelated
Taylor Swift fans are convinced 1989 (Taylor’s Version) could be a double album, and they might be right	Are the Swifties on to something here?	music
Jerry Jones gives mixed signals on Cowboys' trade deadline approach	Cowboys owner Jerry Jones said there will be a "high bar" to trade but indicated his team will be active ahead of the Oct. 31 deadline.	unrelated
Country musician Megan Moroney says she writes sad songs for sad people. It's making her a star.	Not so long before her platinum single “Tennessee Orange” became inescapable on country radio, Megan Moroney was attending the University of Georgia	music
Sam Darnold next to take turn in 49ers’ QB carousel: NFC West Stock Watch	With Brock Purdy in concussion protocol, veteran Sam Darnold could be the fifth QB to take meaningful snaps in the Niners' past 27 games.	unrelated
GOP rising star Mark Robinson’s wretched Facebook feed lands him in trouble ... again	North Carolina’s lieutenant governor, a rising star in the GOP, appears to have posted comments on Facebook quoting Hitler and minimizing the Holocaust.	unrelated
The Hottest Costume This Halloween? The All-American Couple	What this year's most popular Halloween costumes say about our current attitudes	unrelated
Patrick Mahomes wants to 'one-up' Taylor Swift and his wife's handshake with Travis Kelce	When Taylor Swift and Patrick Mahomes' wife went viral for their two handshakes, the quarterback realized he didn't have one with Travis Kelce.	viral_moment
Chiefs star Travis Kelce dances to Taylor Swift's 'Shake It Off' at World Series game	The Kansas City Chiefs star broke out some dance moves to one of Taylor Swift's hit songs during his appearance at Game 1 of the World Series between the Rangers and Diamondbacks.	music
Jennifer Lawrence's full-frontal nude scene; Morgan Wallen looks for love	The Fox News Entertainment newsletter brings you the latest Hollywood headlines, celebrity interviews and stories from Los Angeles and beyond.	unrelated
Taylor Swift to likely miss Travis Kelce's Chiefs game this Sunday as 'Eras Tour' nears return: reports	The Grammy Award winning singer has become a fixture at Chiefs home and road games so far this season, where she has supported Travis Kelce from luxury suites.	miscellaneous 
Britney Spears and Jada Pinkett Smith demonstrate the delicate dance of the celeb memoir	Would you want to revisit your life and your past in order to share it all, both the good and the bad?	unrelated
Apple’s Journal app is kind of smart — and kind of basic	Apple Journal comes with iOS 17.2 and includes features for saving photos, video, text, and more. It also includes a suggestions API that uses AI to try and guess which moments matter most.	unrelated
TMZ: Taylor Swift Won't Attend Travis Kelce, Chiefs' Game vs. Broncos in Week 8	Travis Kelce will be left to his own devices when the Kansas City Chiefs play the Denver Broncos on Sunday. Per TMZ Sports, Taylor Swift won't be attending…	Relationship
Chiefs lose, Travis Kelce has a tough day in Taylor Swift's absence	High-profile tight end Travis Kelce underperformed against expectations Sunday in the Kansas City Chiefs' loss to the Denver Broncos — and his reported sweetheart, Taylor Swift, wasn't there to see it.	Relationship
Unrelated	Five Nights at Freddy's' tops the weekend box office with $78M, the biggest opening for a horror movie in 2023.	Unrelated
AJ Brown sets NFL record as Eagles use second-half surge to beat Commanders	Philadelphia Eagles star wide receiver A.J. Brown was back dazzling everyone on Sunday as he broke the NFL record for most 125-plus receiving yards in six straight games.	unrelated 
NFL Week 8 top viral moments: Best Halloween costumes from around the league	It's Halloween weekend in the NFL, and several players are getting into the spooky spirit with some epic costumes! Check out the best ones we saw here.	unrelated
Taylor Swift has the most adorable stand-in for Chiefs - Broncos: A Corgi dressed like her	Likely not going to see the real Taylor Swift in Denver today, but you do get a super cute stand-in.	Miscellaneous 
Video game adaptation 'Five Nights at Freddy's' tops weekend box office even with simultaneous streaming release	The Blumhouse production adapts the game in which a security guard has to fend off murderous animatronic characters at a family pizza restaurant.	unrelated
Video game adaptation ‘Five Nights at Freddy’s’ notches $130 million global debut	Fans flocked to movie theaters across the country to see the scary video game adaptation “Five Nights at Freddy's” on the big screen, which made $78 million to top the North American box office	unrelated
Halloween candy vs. healthy parenting: Here's how to make it all work	Parenting is hard, especially with candy companies trying turn Halloween into an all-year sugar-buzz festival. We can help them grow without ruining their childhoods.	unrelated
Apple is getting ready for Prime Time	Apple’s big Prime Time event may end up being some iMacs and MacBooks, but given the company’s increased ambitions in Hollywood it could be more.	unrelated
Who Is Chargers Superfan Merianne Do? 5 Things We Know After She Went Viral	Los Angeles Chargers fan Merianne Do went viral when the Chargers played the Dallas Cowboys for her wild celebrations. What do we know about her?	unrelated
Your guide to the internet’s most (and least) important moments	Plus a new Leica camera, the Quiche browser, the Hugo Awards, Google Maps, and more in this week’s Installer newsletter.	unrelated
How to watch tonight's Chicago Bears vs. Los Angeles Chargers NFL game: Livestream options, starting time, more	The Bears face the Chargers for an epic Week-8 matchup that has both teams hungry for a win.	unrelated
How to watch today's Cincinnati Bengals vs. San Francisco 49ers NFL game: Livestream options, starting time	Here's how and when to watch today's game between the Cincinnati Bengals and San Francisco 49ers.	unrelated
How to watch today's Kansas City Chiefs vs. Denver Broncos NFL game: Livestream options, starting time, more	Travis Kelce and the Kansas City Chiefs hit the road to face Russell Wilson and the struggling Denver Broncos.	unrelated
How to watch today's Baltimore Ravens vs. Arizona Cardinals NFL game: Livestream options, starting time, more	Here's how and when to watch today's game between the Baltimore Ravens and Arizona Cardinals.	unrelated
How to watch today's Cleveland Browns vs. Seattle Seahawks NFL game: Livestream options, starting time	Here's how and when to watch today's Cleveland Browns vs. Seattle Seahawks game.	unrelated
How to watch today's Philadelphia Eagles vs. Washington Commanders NFL game: livestream options, starting time	Watch the Washington Commanders try to upset the 6-1 Philadelphia Eagles in an early game today.	unrelated
How to watch today's Atlanta Falcons vs. Tennessee Titans NFL game: Livestream options, starting time, more	Here's how and when to watch today's game between the Atlanta Falcons and Tennessee Titans.	unrelated
How to watch today's Jacksonville Jaguars vs. Pittsburgh Steelers NFL game: livestream options, starting time	The Jacksonville Jaguars seek AFC South domination as they head north to face the Pittsburgh Steelers today.	unrelated
How to watch the New York Jets vs. New York Giants NFL game: Livestream options, starting time, more	In a Big Apple battle, the New York Jets take on the New York Giants in an early game today.	unrelated
How to watch today's New England Patriots vs. Miami Dolphins NFL game: Livestream options, starting time, more	The Patriots proved last week they have what it takes to win tough games. But can they beat the 5-2 Miami Dolphins?	unrelated
Taylor Swift has made Kansas City her new stomping ground — and local shops say business is booming	Kansas City was ready for it: How the city's businesses are embracing the Tayvis relationship.	relationship
How to watch today's New Orleans Saints vs. Indianapolis Colts NFL game: LIvestream options, starting time, more	It's a must-win game for both teams today as the Indianapolis Colts host the New Orleans Saints.	unrelated
How to watch the Minnesota Vikings vs. Green Bay Packers NFL game: Livestream options, starting time, more	The Minnesota Vikings hope to keep their momentum going as they face the Green Bay Packers today.	unrelated
How to watch today's Los Angeles Rams vs. Dallas Cowboys NFL game: Livestream options, starting time, more	The Los Angeles Rams take on the Dallas Cowboys in one of the best NFL matchups of the week. Here's how to watch.	unrelated
How to watch today's Houston Texans vs. Carolina Panthers NFL game: Livestream options, starting time, more	The Houston Texans (3-3) are taking on the Carolina Panthers (0-6) this week. Here's how to watch the NFL game.	unrelated
Taylor Swift, Cardi B, extra guacamole: How New Jersey’s governor spent $12K on stadium concessions	The request came after POLITICO obtained records of taxpayer spending.	miscellaneous 
Ice Spice turns heads in Betty Boop Halloween costume	Ice Spice has shown the world what she’s working with in her latest Halloween costume — and she wasn’t afraid to let it all hang out.	Unrelated
16 Hilarious Fails From The Internet This Week That Will Make You Laugh So Hard You'll Be Texting This Article To Your Friends Saying "You Have To Look At This"	I had to include the Taylor Swift pumpkin because I have been thinking about it every day.View Entire Post ›	Viral_moment
Shannon Sharpe: Travis Kelce at World Series Game 1 Was a 'Horrible' Look	The former NFL tight end believes it was a "horrible look" for Chiefs star to travel to a World Series game on the Friday before he played the Broncos.	unrelated
‘Five Nights at Freddy’s’ dominates Halloween weekend with $78 million debut in North America	The simultaneous release of "Five Nights at Freddy's" in theaters and on streaming had little impact on the film's success on the big screen Halloween weekend.	Unrelated
Broncos Troll Chiefs by Playing Taylor Swift in Arena After Big Win	After their big win, the Denver Broncos used a Swift song to take a swipe against Swift's boyfriend, Travis Kelce, and his Kansas City Chiefs.	NFL
The Voice' adds Wynonna Judd as Mega Mentor for season 24	Country icon Wynonna Judd is joining 'The Voice' as a Mega Mentor for season 24.	unrelated
Chiefs and Patriots compete for fans and influence in Germany ahead of games in Frankfurt	Both the Patriots and the Chiefs are looking to gain bigger followings in Germany leading up to their international match in Frankfurt.	unrelated
Report: NJ Democrat Gov. Phil Murphy Spent Taxpayer Money at Taylor Swift Concert, Other Events	New Jersey Gov. Phil Murphy (D) reportedly spent taxpayer funds at stadium events, including a Taylor Swift concert.	miscellaneous 
Fox News Politics: The next ambassador to Israel	The latest updates from the 2024 campaign trail, exclusive interviews and more Fox News politics content	unrelated
Don't be afraid': Athletes take on Halloween in costumes	LeBron James, Giannis Antetokounmpo and more dressed up big time for Halloween.	unrelated
Mike Johnson Has Already Made His First Mistake	Speaker Johnson has caused controversy by demanding an IRS funding cut in return for aid to Israel.	unrelated
Americans Are Earning More Even as They Complain About the Economy	Wages are rising, but Americans still feel the economy is headed in the wrong direction.	unrelated
Chiefs' Travis Kelce Files for 5 Trademarks for Use on Clothing, Cereal, More	The Travis Kelce business is booming, and the Kansas City Chiefs star is looking to take advantage of it. Per trademark attorney Josh Gerben, Kelce has filed…	unrelated
Mike McDaniel hilariously could not accept that kids were dressing up as him for Halloween	Easily the funniest coach in the NFL.	unrelated
Taylor Swift, Travis Kelce Halloween costume wins friends a top prize: See their rendition of the stars	Florida friends dressed up as Taylor Swift and Travis Kelce for a Halloween costume contest and took home the grand prize. See the pair mimick the iconic duo!	viral_moment
Halloween 2023: A look at the viral moments that inspired people's costumes this year	Many online are sharing their Halloween costumes that were inspired by viral moments, pop culture trends and iconic internet memes.	unrelated
New Jersey governor spent $12K on stadium events, including a Taylor Swift concert	Politico reports New Jersey Gov. Phil Murphy tapped into a taxpayer-financed expense account for nearly $12,000 at MetLife Stadium, including almost $1,000 for a Taylor Swift concert in 2018	miscellaneous 
Scarlett Johansson hits AI app with legal action for cloning her voice in an ad	Scarlett Johansson is taking legal action against an AI app developer for using her likeness in an online ad without her consent.	unrealted
Kelly Clarkson ripped her pants while filming 'Since You've Been Gone' music video: ‘I was commando’	Kelly Clarkson revealed that she ripped her pants while filming the music video for "Since You've Been Gone," when speaking to Kyle Richards.	unrealted
Travis Kelce calls Chiefs' loss to Broncos 'embarrassing'	Travis Kelce did not hold back when discussing the Chiefs' loss to the Broncos on his podcast, placing blame on the offense.	unrealted
‘Fingernails’: A form of cinematic torture	Jessie Buckley, Jeremy Allen White and Riz Ahmed star in a silly, sci-fi story of a love triangle.	unrealted
Travis Kelce laughed so hard at a 'Taylor Swift put Travis on the map' Halloween costume	Travis Kelce loved this and so did we.	Relationship
Travis Kelce really appreciated everyone dressing up as him and Taylor Swift on Halloween	All the Travis Kelce and Taylor Swift Halloween costumes were approved by the man himself!	viral_moment
Video: Chiefs' Travis Kelce Reacts to Viral Taylor Swift Halloween TikTok Costume	Travis Kelce appreciates the jokes. The Kansas City Chiefs tight end reacted to a TikTok from JaxWritesSongs that played on the prank of Taylor Swift fans…	viral_moment
A Taylor Swift Airbnb is a bachelorette dream home where megafans can bask in her "Eras" for up to $1,400 a night	You can rent this Taylor Swift Airbnb in Scottsdale, Arizona. Each room is devoted to a different era, from "Reputation" to "Lover" to "Folklore."	Miscellaneous 
Get Your Parkas Ready For December 2024 – Canadian Swifties Haven't Been Able To Focus Since Taylor Swift JUST Announced Three New Concert Dates	Step 1) Register for Verified Fan Presale on Ticketmaster. Step 2) Look at flights to Vancouver.View Entire Post ›	music
FOX Super 6 NFL contest: Chris 'The Bear' Fallica's Week 9 picks	The FOX Super 6 NFL contest has already given away $80,000. Will you be the next winner? If you need a little help, Chris "The Bear" Fallica has you covered with his picks.	unrelated
Canada’s economy faces $900-billion mortgage renewal shock	The biggest shock awaits variable-rate mortgages set to renew in 2026. A five-year variable mortgage renewing in October of that year would see payments jump 76 per cent if mortgage rates stayed around 6 per cent	unrealted
Taylor Lautner simply can’t stop backflipping at Taylor Swift’s events	Taylor Lautner, of Twilight fame, has backflipped not once but twice at Taylor Swift Eras Tour events. Apparently, he did it due to anxiety.	viral_moment
Travis Kelce plays into joke that Taylor Swift 'put me on the map'	Travis Kelce is getting in on the joke that Taylor Swift put him "on the map." The narrative even inspired a couple's Halloween costume, which Kelce "enjoyed."	viral_moment
Mike Clay's NFL Betting Playbook for Week 9	Mike Clay pits his projection system against the sportsbooks with a game-by-game look at Week 9 player props, offering his leans for taking the over or the under.	unrealted
NewJeans says they’re more than solely K-pop stars as they break global barriers	NewJeans is reflecting on being the first K-pop girl group to be nominated for the “Top Billboard Global (Excl. U.S.) Artist” award.	Unrealted
Travis Kelce's Stylist Responds to Taylor Swift Wardrobe Conspiracies	The Kansas City Chiefs star has worn clothes that look like Easter Eggs for Swift's fans. Were the nods to Swift's work intentional?	miscellaneous 
Taylor Swift to bring Eras Tour to Vancouver for 3 nights in December 2024	Taylor Swift is preparing to bring her Eras Tour to Vancouver for three nights next December.	music
Tyreek Hill jokes Taylor Swift fans are 'a dangerous crew' after Travis Kelce question	He knew it would be trouble if he said something negative about Taylor Swift and Travis Kelce.	Relationship
Travis Kelce asked if he's 'in love' with Taylor Swift, addresses relationship 'status'	Travis Kelce and Taylor Swift are all but officially official, which prompted a reporter in Germany to ask the Chiefs star if he's "in love."	Relationship
Vancouver hotels rooms already sold out for Taylor Swift's 2024 concert dates	Vancouver is expecting an economic boon from Taylor Swift's 2024 concert dates, but Swifties are already finding hotel rooms sold out.	music
See NSYNC's troll transformation in 'Trolls Band Together'	The members of NSYNC are getting a sparkly troll transformation in 'Trolls Band Together' — here's your first look.	unrealted
A Reporter Asked Travis Kelce The Status Of His Relationship With Taylor Swift, And Fans Love His Response	Travis is keeping his cards close to his chest.View Entire Post ›	Relationship
How to watch every Kansas City Chiefs game this season	We've got all the information you need to watch every Chiefs game this season (even the one that isn't on network TV).	unrealted
Travis Kelce won't say if Taylor Swift will be in Germany and jokingly blames oddsmakers for it	Those pesky oddsmakers always getting in the way	Relationship
How Taylor Swift could make it to a Travis Kelce Chiefs Super Bowl while on tour, according to Drew Barrymore	Drew Barrymore figured out how Taylor Swift could see Travis Kelce play the Super Bowl in person.	Relationship
Kelce: Chiefs have every piece needed to be great	The Chiefs heading into Sunday's game against the Dolphins haven't been an offensive power like in previous seasons. But tight end Travis Kelce said that's not because the Chiefs are deficient at wide receiver.	unrelated
Taylor Swift’s Eras Tour concert film takes its final bow at the box office this weekend	Taylor Swift takes her final bow at the movie box office this weekend.	awards
Taylor Swift and Beyoncé concert tours deliver record-breaking earnings for Live Nation	Live Nation has Taylor Swift and Beyoncé to thank for propelling the live concerts organizer to its strongest quarterly results to date.	music
Will Taylor Swift be at the Chiefs’ game in Germany? Travis Kelce wouldn’t say	Travis Kelce declined to discuss Taylor Swift’s status for the Chiefs' game Sunday in Germany — but left the door open.	relationship
Travis Kelce Addresses Whether He Is in Love With Taylor Swift	The Kansas City Chiefs star kept his cards close to the vest when a reporter in Germany asked him about his feelings for Swift.	Relationship
Travis Kelce has the smoothest answer when asked if he's in love with Taylor Swift	IS TRAVIS KELCE IN LOVE WITH TAYLOR SWIFT? He actually has an answer beyond "no comment."	Relationship
Will Taylor Swift be at the Chiefs' game in Germany? Travis Kelce wouldn't say	Travis Kelce has declined to discuss Taylor Swift’s status for Sunday’s game in Germany — and their status as a couple	Relationship
Why Travis Kelce and the Chiefs are playing in Germany in Week 9, explained	Here's the answer.	unrelated
Big Weekend: Rich Eisen reflects on NFL Network turning 20 and calling Chiefs-Dolphins on Sunday	Rich Eisen has had many memorable moments during his long tenure at NFL Network	unrelated
Fantasy Football Week 9 Rankings: Each Position's Flex and PPR Projections	Let's break down some PPR rankings. Below, we've compiled the rankings for quarterbacks, running backs, wide receivers and tight ends utilizing Fantasy Pros'…	unrelated
Riley Gaines says 'transphobe' accusations carry 'literally no weight'	Former NCAA swimmer Riley Gaines made an appearance at UC Davis earlier this week, where she continued to fight for fairness in girls' and women's sports.	unrelated
Travis Kelce Said 'I'm Gonna Find a Breeder' Months Before Dating Taylor Swift	"Mr. Taylor Swift" Travis Kelce of the Kansas City Chiefs made headlines Saturday after an unearthed podcast revealed the tight end saying he was looking for a "breeder" to "get kids" just months before he started dating the singer.	Relationship
Chiefs want to be ‘world’s team’ behind star power, Super Bowl success	Can the Chiefs rule the world? With championships, Patrick Mahomes, Travis Kelce — and Taylor Swift! — why not?	unrelated
Bears, Montez Sweat agree to $98 million extension shortly after trading for him: reports	Montez Sweat and the Chicago Bears have reportedly agreed to a four-year, $98 million extension less than a week after he was traded to the team.	unrelated
Chiefs want to be 'world's team' by going global with star power and Super Bowl success	The Kansas City Chiefs say Sunday's game in Frankfurt against the Miami Dolphins is a big step in the organization's plan to become the “world’s team.”	unrelated
2023 NFL Odds: Taylor Swift's presence in Germany could affect betting market	You guessed it: Taylor Swift is now affecting the betting market. And whether or not she makes it to Germany for Sunday's game could affect Travis Kelce player props.	NFL
Amazon Echo Show 8 (3rd gen) review: the near-perfect smart display for most households	The Amazon Echo Show 8 (3rd gen) is better than ever, coming in strong with much-needed upgrades from the previous generation. Is it finally time to move on from smart speakers and get the best of both worlds instead?	unrelated
Travis Kelce Roasted by Social Media Users for His Trademark Filings	The Kansas City Chiefs star might have spotted a few business opportunities as his relationship with Taylor Swift raises his profile.	Relationship
NFL Nation update: Invest in Raiders?	Our NFL Nation reporters answer key questions heading into the weekend's games, including what to expect from the Raiders and the Saints' Taysom Hill.	unrelated
Gen Z's financial icons revealed: Taylor Swift beats Warren Buffett, and Bill Gates tops the list	Bill Gates, Beyoncé, and Oprah Winfrey made the list of people who embody financial success for Gen Z, according to a new survey of college students.	miscellaneous
These 34 Beauty Products Are So Amazing A Wizard Must’ve Cast A Spell On Each Of Them	You won't even need a fairy godmother to give you a ~magical~ makeover because these products have you covered.View Entire Post ›	unrelated
Travis Kelce's New Business Venture Isn't a Touchdown With Chiefs Fans	Think Travis Kelce has the Midas touch? Well, one of his newer endeavors isn't receiving the greatest reception online.	unrelated
Taylor Swift and Brittany Mahomes had dinner in NYC with Selena Gomez instead of going to Germany and we get it	Swift didn't make the trip to Europe with the next international leg of The Eras Tour starting soon.	viral_moment
A muted box office weekend without ‘Dune: Part Two’	Universal and Blumhouse's video game adaptation “Five Nights at Freddy's” topped the North American box office in its second weekend according to studio estimates Sunday, while “Taylor Swift: The Eras Tour” placed second	viral_moment
Chiefs' wild fumble-return sequence leads to improbable touchdown vs Dolphins	A wild fumble return helped the Kansas City Chiefs take a comfortable lead into halftime against the Miami Dolphins in Germany on Sunday.	unrelated
Referee for Dolphins-Chiefs in Frankfurt announced a penalty in German and the home crowd loved it	Referee Clay Martin was well prepared for this moment.	unrelated
Taylor Swift, Selena Gomez, Brittany Mahomes spotted in NYC ahead of Travis Kelce's game in Germany	Taylor Swift, Selena Gomez, Sophie Turner and Gigi Hadid were spotted with Brittany Mahomes outside a New York City restaurant Saturday.	miscellaneous
Aaron Rodgers' Social Media Has Old Teammate Thinking About Early Return	When could Aaron Rodgers take the field for the New York Jets? A social media post may have highlighted a specific date.	unrelated
Taylor Swift supports Travis Kelce with rare social media move	Taylor Swift liked an Instagram post about Travis Kelce's performance from his game in Germany on Sunday, sending fans into a frenzy over the public act of support.	relationship
Taylor Swift’s latest master stroke is a blockbuster re-recording of her breakthrough pop album—and it could reshape the music industry as we know it	The newest version of "1989 TV," released at the end of October, sold 1.65 million copies in its first week. "It's a career-defining moment."	music
Taylor Swift reporter hired at Gannett after viral job listing | CNN	Consider journalist Bryan West the “lucky one,” because he’s The Tennessean and USA Today network’s new Taylor Swift Reporter.	viral_moment
Jason Kelce Got Drug Test From NFL After Big Birthday Win	The Philadelphia Eagles center also had a viral altercation with Dallas Cowboys linebacker Damone Clark on a busy Sunday.	unrelated
Taylor Swift reportedly hosted wives of Travis Kelce's teammates at a Chiefs watch party	Wives of Travis Kelce's teammates were seen leaving Swift's Tribeca home on Sunday.	unrelated
Taylor Swift Went Out With A Large Group Of Famous Girlfriends, And It's Just Looking Worse And Worse For Joe Jonas	I imagine them doing some sort of Hocus Pocus hexing spell while eating the biggest ball of burrata you've ever seen.View Entire Post ›	viral_moment
Giants' Daniel Jones suffers torn ACL, season likely over for star QB	New York Giants quarterback Daniel Jones will miss the rest of the season as Brian Daboll announced he tore his ACL in Sunday's game against the Las Vegas Raiders.	unrelated
Taylor Swift adds Brittany Mahomes to her squad | CNN	Taylor Swift adds Brittany Mahomes to her squad | CNNcnn.com	viral_moment
Brittany Mahomes shared a glimpse of what it was like to hang out with Taylor Swift in NYC	Swift spent time with the spouses of three Chiefs' players this past weekend.	viral_moment
Taylor Swift Calls on Fans to Hit the Polls Ahead of Major Elections in Several States	Pop star Taylor Swift, the jet-setting climate change activist who endorses Democrats, attacks Republicans, and performs for Communist human rights abusing-China’s Singles Day, took to social media on Tuesday to encourage her fans in certain states to vote on…	viral_moment
5 wildest NFL betting moments (so far) this season, including Patrick Mahomes' slide	There have been plenty of bad beats so far this NFL season.	unrelated
A 35-year-old ‘huge Swiftie’ beat out a White House reporter and a legion of bloggers to get the most coveted job in journalism	It’s “no different than being a sports journalist who’s a fan of the home team,” said Bryan West, the new Taylor Swift reporter for USA Today.	miscellaneous
Report: Taylor Swift hosted watch party for Chiefs significant others Sunday	Taylor Swift reportedly hosted a watch party to root on rumored boyfriend Travis Kelce as the Chiefs took on the Dolphins in Germany last Sunday.	viral_moment
Taylor Swift & Brittany Mahomes party before Chiefs game, King Charles' reported control over Harry & Meghan	The Fox News Entertainment newsletter brings you the latest Hollywood headlines, celebrity interviews and stories from Los Angeles and beyond.	viral_moment
Voters to decide KY governor, OH abortion rights and VA legislative control... Developing...	Voters to decide KY governor, OH abortion rights and VA legislative control... Developing...         (First column, 1st story, link)           Related stories:Dems seek upset in MS gov race... Youngkin's Presidential Ambitions Face Test...	unrelated
Concert movies are the future of pop music fandom	Taylor Swift, BTS, and Beyoncé’s concert movies level the field for fans. Once considered secondary to live shows, filmed concerts are now essential to fandom.	music
Rob Schneider Under Fire Over Travis Kelce Comment	"Not true just more lies," one person wrote, while another added: "Not sure Travis knows who Rob even is."	unrelated
Does Taylor Swift really swing betting odds when she's at Chiefs games?	As absurd as the premise sounds that the mere presence of a songstress love interest could appeal to the oddsmakers' soft side, there is at least a statistical starting point for a discussion.	miscellaneous
USA Today hires a Taylor Swift reporter. Who is he?	Gannett, the biggest newspaper chain in the U.S., no longer has a blank space under the title of “Taylor Swift reporter.”	miscellaneous
Movie Review: Nicolas Cage finds fame to be highly overrated in chillingly funny ‘Dream Scenario’	Nicolas Cage, perhaps best known for his onscreen volatility, takes a fascinating swerve to play a mundane, schlubby, balding professor at nowhere famous in Kristoffer Borgli's “Dream Scenario.”	unrelated
Taylor Swift Promoted Left-Wing Voter Registration Organization While Remaining Silent on Hamas' Massacre of Israelis	Mega pop star Taylor Swift used her massive social media following to promote a left-wing voter registration organization on election day. But the singer continues to remain silent on Hamas' massacre of Israelis more than a month after the October 7 slaughter.	miscellaneous
Travis Kelce Might Go 'Closer to the Equator' During Chiefs Bye Week	On his podcast, the Kansas City Chiefs star told his brother Jason that he plans to go "somewhere sunny" during his week off.	unrelated
Taylor Swift's Argentina concert takes political turn as presidential election nears	Politics was suddenly a topic of conversation as thousands of Taylor Swift fans eagerly lined up for the superstar’s first-ever concert in Argentina	music
How to watch or stream Thursday Night Football’s Week 10 during the 2023 NFL season live online free without cable	Here's how to watch Thursday Night Football during the 2023 NFL season online for free—even without a cable subscription.	unrelated
Mom told to remove decorations from son's gravesite — plus Taylor Swift 'swear jar' goes viral	The Fox News Lifestyle Newsletter brings you trending stories on family, travel, food, neighbors helping neighbors, pets, autos, military veterans, heroes, faith and American values.	viral_moment
An expensing firm CFO just revealed how remote work changes employee perks	For proof, take a look at the $21,000 VIP dinner, $350 haircut, and Taylor Swift concert tickets that workers got reimbursed last year.	miscellaneous
NC State football perfectly invoked Taylor Swift for Payton Wilson's postseason awards campaign	This is a winning combo.	NFL
Far-right hosts are blaming the GOP's big election losses on Taylor Swift	Right-wing activist Jack Posobiec and commentator Charlie Kirk both blamed Taylor Swift's political power for electoral losses.	miscellaneous
Tumblr is reportedly on life support as its latest owner reassigns staff	"600+ person-years of effort" have not stopped the site from losing $30M a year.	unrelated
Dry Swifties or Wet Swifties? This Buenos Aires weather report (Taylor's version) is too funny	The buzz is high in Argentina with the Eras Tour starting back up.	miscellaneous
What to Watch Out For on the Next Leg of Taylor Swift’s Eras Tour	The singer has finished the first U.S. leg of her historically popular Eras Tour and is headed to South America.	music
Travis Kelce Reportedly Will Travel to Argentina to Visit Taylor Swift	The Kansas City Chiefs star will use the team's bye week to visit Swift during the international leg of her Eras Tour.	music
Taylor Swift postpones Argentina concert after Travis Kelce arrives	Taylor Swift canceled the Nov. 10 concert of the international leg of "The Eras Tour" due to "chaotic" weather. Her rumored boyfriend, Travis Kelce, just arrived in the country.	music
Argentina Socialists Weaponize Taylor Swift Against Conservative Presidential Frontrunner	Leftist fans of Taylor Swift in Argentina launched a campaign urging fellow Swifties not to vote for libertarian economist Javier Milei.	miscellaneous
SZA leads Grammy nominations, up for "Album of the Year" with Miley Cyrus, Taylor Swift and Janelle Monáe	The 66th Grammy Awards nominations have been announced and SZA tops the list with nods in nine categories. Joe Levy, a contributor editor for "Rolling Stone," joins CBS News with a look at the artists nominated.	award/top_charts
Biden Gets Bad Economic News as Polls Spell Disaster	Consumers expect inflation to be high in 2024 just as President Joe Biden will be seeking re-election.	unrelated
Taylor Swift reschedules ‘Eras Tour’ performance	Taylor Swift reschedules ‘Eras Tour’ performancecnn.com	music
AMC Theatres posts best revenue and attendance since pandemic began as it closes money-losing locations and rakes in cash from 'Barbenheimer' bonanza	The mega movie theater chain has closed 156 locations since the start of the pandemic.	unrelated
Taylor Swift cancels Friday night show in Buenos Aires after Travis Kelce arrives in Argentina	Taylor Swift called off her Friday night Eras Tour show in Buenos Aires due to intense rain even after Travis Kelce showed up to watch her perform.	music
Taylor Swift fans swoon over Travis Kelce’s hours-long red-eye flight to be at the Eras Tour in Argentina	Travis Kelce took an overnight flight some 5,600 miles across the globe to be there for Taylor Swift!	relationship
2024 Grammy nomination snubs and surprises: No K-pop, little country and regional Mexican music	With new categories, “Barbie” and SZA — there’s a lot to discuss regarding the 2024 Grammy Award nominations	unrelated
Classes on celebrities like Taylor Swift and Rick Ross are engaging a new generation of law students	A South Dakota law professor who typically teaches torts and natural resources is turning his attention to Taylor Swift next semester	miscellaneous
		
Insider Today: Financial freedom's reality	Two people who consider themselves financially free shared a glimpse of what their lives are like — and it's actually a lot of work.	unrelated
Young Taylor Swift fans go viral for struggling to open the star's CD: 'Making me laugh'	Three Taylor Swift fans, ages 11 and 12, go viral after a video of their struggles to open a CD grab over 2.7 million views — and even Swift herself responded.	viral_moments
Cornwall unveils winter housing plan in shadow of encampment resident's death	An eastern Ontario city's plan to house homeless people this winter is being met with a mix of relief and regret, coming less than a week after a homeless woman died in a local encampment.	unrelated
Roles reversed: Kelce uses bye week to attend Swift's performance	After weeks of Taylor Swift making headlines for attending Chiefs games, it was Travis Kelce's turn to garner attention with his appearance in Buenos Aires.	music
The Marvels' has MCU's worst box office opening ever	The Marvels' went lower, nearer, and slower with MCU's worst box office opening ever, grossing $47 million.	unrelated
‘The Marvels’ struggles at box office amid superhero fatigue: ‘The growth of the genre has stopped’	The 33rd installment in the Marvel Cinematic Universe managed less than a third of the $153.4 million its predecessor launched with.	unrelated
House may consider Mayorkas impeachment this week	The House may consider a resolution this week that aims to impeach Homeland Security Secretary Alejandro Mayorkas after a push by Rep. Marjorie Taylor Greene (R-Ga.) to do so, according to the chamber’s schedule of measures it plans to consider. The Mayorkas …	unrelated
WATCH: Taylor Swift and Travis Kelce share a kiss after her Buenos Aires concert	Video shows the singer and Chiefs’ tight end embracing each other after her show.	relationship
10 of Taylor Swift and Travis Kelce's most heartwarming moments from The Eras Tour in Argentina	Taylor Swift and Travis Kelce had the absolute best time Saturday night.	relationship
Taylor Swift changes 'Karma' lyric for Travis Kelce at Eras concert	Taylor Swift shouted out Travis Kelce in a 'Karma' lyric change at a show in Argentina: 'Karma is the guy on the Chiefs, coming straight home to me.'	relationship
Travis Kelce Saw Taylor Swift Perform in Argentina. Here's What Happened	Kelce was spotted at Swift's Eras Tour show in Argentina on Saturday, with the pop star having a surprise in store for her guest.	relationship
Travis Kelce reacts to Taylor Swift changing 'Karma' lyrics to reference the Chiefs	Kansas City Chiefs tight end Travis Kelce appeared just as surprised as concertgoers when he received an onstage shoutout from Taylor Swift during her Eras Tour show in Argentina.	miscellaneous 
The Marvels Wins the Box Office But Has the Worst MCU Opening Weekend of All Time	While The Marvels may have won the domestic weekend box office, it also had the worst MCU opening of all time with ticket sales of $47.0 million.	unrelated
Taylor Swift changes lyrics to ‘Karma’ in nod to ‘guy on the Chiefs’ Travis Kelce | CNN	Taylor Swift winked at her romance with Kansas City Chiefs’ tight end Travis Kelce during her “Eras Tour” concert in Buenos Aires, Argentina on Saturday when she changed the lyrics to a line in her hit song “Karma,” and Kelce was in the audience to catch it.	relationship
Taylor Swift's dad (an Eagles fan!) wore a Chiefs lanyard while with Travis Kelce at the Eras Tour	Taylor Swift fans loved this. Eagles fans? Not so much.	relationship
Patrick Mahomes Joining ESPN's ManningCast After Failed 'Audition' For Show	The Kansas City Chiefs quarterback was featured in an Omaha Productions skit with Peyton and Eli Manning over the summer.	unrelated
US professors use pop culture icons like Taylor Swift and Rick Ross to make law school more engaging	Law professors across the U.S. are incorporating pop culture icons like Taylor Swift and Rick Ross into their courses in an effort to engage students.	miscellaneous 
The Taylor Swift bowl, Victor Wembanyama vs. Chet Holmgren and more on this week's betting calendar	NFL Week 11 features a rematch of Super Bowl 57 between the Eagles and Chiefs.	NFL
Taylor Swift Expressed Her Discomfort With Fans Throwing Stuff Onstage: "It Really Freaks Me Out"	Everyone needs to chill.View Entire Post ›	miscellaneous 
Taylor Swift fans think her grateful message to Buenos Aires used one of Travis Kelce's favorite phrases	Maybe Taylor Swift already has the word “electric” in her vocabulary — heck, she has a song called Electric Touch! — to describe the die-hard crowds during the Eras Tour, bu…	relationship
NFL Finally Dumps Taylor Swift from Social Media, Replaces Her with Vikings' Josh Dobbs	After a 42-day run, the NFL has finally removed images and tributes to pop star Taylor Swift as the features on its social media accounts.	NFL
Josh Dobbs Isn't a Just Viral Story, He's a Valuable Lesson for Sports Fans	While the Vikings quarterback has become the talk of the NFL over the past couple of weeks, he's more than just a feel-good story.	unrelated
Brutal Travis and Jason Kelce Comparison Goes Viral	Jason Kelce was a finalist for People Magazine's "Sexiest Man of the Year" 2023, while brother Travis Kelce didn't make list.	unrelated
Taylor Swift concert postponement prompts airline to waive change fee | CNN	LATAM Airlines waived its change fees for customers who wanted to extend their stay in Buenos Aires, Argentina, after Taylor Swift postponed her concert there.	music
Travis Kelce, Taylor Swift budding relationship draws wholesome remark from Andy Reid	Kansas City Chiefs head coach Andy Reid remarked on Travis Kelce's relationship with Taylor Swift as he spent his bye week in Argentina to see the pop star.	relationship
Chiefs' Travis Kelce joins Jason Kelce on 'A Philly Special Christmas' single	Travis Kelce joined his brother, Jason, to sing a holiday song for the second edition of the album "A Philly Special Christmas."	unrelated
Will Taylor Swift fans send the Travis and Jason Kelce holiday song to No. 1?	That's right, the Kelce brothers have a holiday song coming out!	relationship
Google sues people who “weaponized” DMCA to remove rivals’ search results	Google says DMCA fraudsters filed copyright takedown notices for 600,000+ URLs.	unrelated
Why football in Premier League and Europe is anything but a fair fight	It's not surprising that big teams with lots of resources and money might win more trophies -- just look at Man City's dominance in recent seasons -- but what might surprise you is the sheer scale of this inequality.	unrelated
Andy Reid Says Opposing Coaches Don't Call Him About Taylor Swift	The Kansas City Chiefs coach said he is happy that star tight end Travis Kelce has "found somebody he likes."	relationship
Jason Kelce Came Into Her Hot Dog Restaurant and 'Tried To Roast the Queen'	The Eagles center made a good impression on employees at Wiener's Circle, including resident trash-talker Poochie Rollins.	unrelated
A noisy rock 'n' roll': How growing interest in Formula One is felt across the music world	Beyond the engineering, the athleticism, the speed, the luxury, fans love the sound of Formula One	unrelated
Gigi Hadid Breaks Silence on Taylor Swift's Romance With Travis Kelce	Gigi Hadid has denied she doesn't approve of Taylor Swift's relationship with football star Travis Kelce moving so fast.	relationship
Taylor Swift surprises Travis Kelce at concert, pleads with fans to stop throwing things on stage	The Fox News Entertainment newsletter brings you the latest Hollywood headlines, celebrity interviews and stories from Los Angeles and beyond.	relationship
Patrick Mahomes says he’s worn the same pair of underwear every game since his first NFL season	Travis Kelce spent the Kansas City Chiefs’ bye week carousing through South America with Taylor Swift.	relationship
Travis Kelce’s old tweets are resurfacing online, and some Swifties are here for it	Taylor Swift and Travis Kelce's viral public relationship has captivated the internet. Now, so have some of Kelce’s old tweets.	relationship
Patriots legend Rob Gronkowski says Mac Jones should ask for release now: 'He's not respected'	Mac Jones' tenure with the New England Patriots has hit rock bottom at 2-8 in his third season, and legend Rob Gronkowski believes he should ask for his release now.	unrelated
Donna Kelce discusses seeing The Eras Tour movie and whether Taylor Swift will be there for Chiefs - Eagles	Momma Kelce said the film adaptation of the popular tour was "amazing."	miscellaneous 
Report: Travis Kelce, Taylor Swift's Parents Expected to Meet at Eagles vs. Chiefs	Travis Kelce and Taylor Swift appear to be taking the next step in their relationship. The parents of the Chiefs tight end and world-renowned…	relationship
Olive Garden chimes in on an old Travis Kelce tweet with a fun Taylor Swift lyric change	Let's head down to the ole Garden and get some breadsticks and listen to Taylor Swift.	relationship
Fans speculate Travis Kelce keeps texting Taylor Swift during episodes of New Heights podcast	Honestly, if we could text Taylor Swift, we'd be doing it all the time, too.	relationship
Travis Kelce's Old Tweets Are Going Viral, And It's Making Everyone Like Him 1,000 Times More	This is the next-level himbo Ken energy, and I love it.View Entire Post ›	unrelated
Travis Kelce says Taylor Swift's lyric change at Argentina concert 'shocked' him	Taylor Swift referenced Travis Kelce in a song and embraced the Chiefs star during her "Eras Tour" international concert series.	relationship
Travis Kelce's astonishingly philosophical tweet from 2012 had Taylor Swift fans making so many jokes	When you take your first philosophy class ...	miscellaneous 
Kelce' becomes a top trending dog name in America, pet company's data shows	Recent data from Rover has shown that a top trending dog name in America right now is "Kelce," amid coverage of the Kansas City Chiefs player and girlfriend Taylor Swift.	miscellaneous 
Eagles' Kelce: 'I don't buy into' revenge games	Eagles center Jason Kelce said he does not buy into revenge games ahead of Monday night's showdown against the Kansas City Chiefs, who beat the Eagles 38-35 in last year's Super Bowl.	unrelated
Travis Kelce's Old Tweets Reposted by Taylor Swift Fans Ahead of Eagles vs. Chiefs	Taylor Swift fans are a passionate, unique bunch. Swifties have been digging into the old tweets of Travis Kelce, Swift's current beau, to the point that many…	miscellaneous 
It's refreshing': Wall Street analysts show they're Taylor Swift superfans too by riffing on her songs in their usually wonky research notes	Analysts are giving a nod to Swift’s reign at the pinnacle of pop culture by referencing her lyrics in their financial research.	miscellaneous 
Travis Kelce Now Has a No. 1 Song to His Name	Think Taylor Swift is the only one with musical talent? Travis Kelce appeared on a song, and it's performing rather well.	music
Michigan's Jim Harbaugh agrees to serve 3-game ban, Big Ten drops sign-stealing investigation	Michigan coach Jim Harbaugh agreed to serve a 3-game suspension over the school's sign-stealing scandal and the Big Ten has dropped its investigaton.	unrelated
Philadelphia Radio Station Won't Play Taylor Swift Songs Ahead of Eagles vs. Chiefs	While pop superstar Taylor Swift is a native of Pennsylvania and grew up a Philadelphia Eagles fan, her allegiance to Kansas City Chiefs star tight end Travis…	relationship
Brazil's Christ the Redeemer statue welcomes Taylor Swift with unique display	Taylor Swift and the Eras Tour will receive a special welcome to Rio de Janeiro on Thursday night with a projection on the city's iconic Christ the Redeemer.	music
Travis Kelce's old tweets unearthed; Taco Bell, Olive Garden, Chipotle respond	Taylor Swift fans have resurfaced old Travis Kelce tweets amid reports that the duo's parents will meet at the Chiefs-Eagles game.	relationship
Joy Behar doesn’t want Taylor Swift stuck with ‘idiot’ Travis Kelce	The View' host Joy Behar doesn't want Taylor Swift to be 'stuck with this idiot' Travis Kelce after several of his posts making disparaging comments about women resurfaced online: 'He’s illiterate.'	relationship
How to watch tonight's Cincinnati Bengals vs. Baltimore Ravens game on TNF: Livestream options, kickoff time	Here's how to watch Lamar Jackson and the Baltimore Ravens face Joe Burrow and the Cincinnati Bengals on TNF.	unrelated
Travis Kelce's Unintentionally Hilarious Unearthed Tweets Have Officially Become A Meme	He's all of us.View Entire Post ›	unrelated
The 5 most watchable NFL games for Week 11 2023, ranked	Here are the best games to watch in Week 11.	unrelated
Taylor Swift fans think Eras Tour bracelets lit up with Chiefs colors during her End Game performance	Big reputations and now gold and red bracelets!	music
VIDEO — 'Precious': Donald Trump Visits His Granddaughter at School	Former President Donald Trump visited his granddaughter, Carolina, at school, and the little girl showed her grandpa her desk.	unrelated
Taylor Swift fans used record amounts of data during the Eras Tour in North America	A staggering 29 terabytes of glitter moved through AT&T’s network during her stop in Arlington, Texas, and Swifties set data usage records almost everywhere else.	Miscallenous
Philly radio station 'punts' Swift from weekend playlist ahead of Chiefs-Eagles	Taylor Swift grew up an Eagles fan, but her relationship with Chiefs tight end Travis Kelce is causing one Philadelphia radio station to take no chances.	relationship
KELCE?! The Surprising Most Popular New Pet Names in American Study	The report shows that U.S. pet owners have quite the sense of humor.	unrelated
The 23 most delightfully goofy Travis Kelce tweets unearthed by Taylor Swift fans	These are all so wholesome.	unrelated
3 ways to increase your privacy and save money when booking travel	Kurt "CyberGuy" Knutsson takes on protecting privacy and saving money while booking travel plans through the use of creating an email alias.	unrelated
Travis Kelce apologizes to Taylor Swift’s dad | CNN	Remember when Travis Kelce said he was going to stick to talking about football and not his private life? Good thing for the Swifties it looks like he didn’t mean it.	relationship
NHTSA misses deadline on potentially life-saving new rules for vehicle seats	The National Highway Traffic Safety Administration was supposed to propose new vehicle safety regulations by Nov. 15.	unrelated
Celebrities Who Refuse to Perform in Israel	Roger Waters of Pink Floyd has been a prominent critic of Israel but other musicians have also turned down the chance to play in the country, albeit less vocally.	unrelated
Drew Barrymore doesn't want plastic surgery: 'I worry I'd continue to chase it'	Drew Barrymore says that she's never had plastic surgery and doesn't picture herself getting any, saying her "highly addictive personality" might cause her to go overboard.	unrelated
Rooms, an interactive 3D space designer and ‘cozy game,’ arrives on the App Store	Cozy game, interior decorating app, learn-to-code primer, or something in between, the interactive, 3D spaces builder known as Rooms has made its way to the App Store. The startup, which earlier raised $10 million in seed funding led by a16z, offers a way to …	unrelated
Eagles' Jason Kelce on Chiefs Matchup: 'I Don't Buy into Super Bowl Revenge Games'	While most of the coverage for the upcoming Monday Night Football game between the Philadelphia Eagles and Kansas City Chiefs is describing it as a rematch of…	unrelated
Taylor Swift 'overwhelmed by grief,' postpones Rio show after fan dies during Eras Tour concert	Taylor Swift postponed an Eras Tour concert in Rio de Janeiro Saturday after a 23-year-old fan died during her Friday night show, according to a message posted on the singer's Instagram.	music
2023 College Football, NFL odds: Best bets for Washington-Oregon State, Eagles-Chiefs	Sammy P took a look at the weekend football slate to serve up his best bets. Read to see who he likes in the Kansas State-Kansas matchup and which Pac-12 contest he's betting to go Over.	unrelated
Taylor Swift postpones Eras Tour concert in Rio de Janeiro due to heat	Taylor Swift announced that her concert scheduled for Saturday in Rio de Janeiro, Brazil has been postponed due to high temperatures.	music
Taylor Swift postpones Rio show after a fan's death during her Friday night concert	Taylor Swift postpones Rio show after a fan's death during her Friday night concert	music
Taylor Swift postpones Brazil concert due to 'extreme temperatures'	Taylor Swift announced that her Saturday night Eras concert in Rio de Janeiro has been postponed due to "extreme temperatures."	music
Taylor Swift postpones Rio show after a fan's death during her Friday night concert	Taylor Swift postpones Rio show after a fan's death during her Friday night concert	music
Taylor Swift fan dies before 'The Eras Tour' concert in Rio de Janeiro, Brazil	Taylor Swift fan dies before 'The Eras Tour' concert in Rio de Janeiro, Brazilgo.com	music
Fans think this 2009 Travis Kelce tweet about college football is just so relatable	2009 Travis Kelce was just having a good time.	unrelated
Rio de Janeiro Officials Project Taylor Swift Welcome onto Famed 'Christ the Redeemer' Statue	Officials in Rio de Janeiro were so excited about pop star Taylor Swift's imminent concerts in Brazil that they electronically projected a Swifty-themed robe onto its famed Christ the Redeemer statue that overlooks the glittering city.	music
Taylor Swift fan dies at Rio concert amid complaints about excessive heat	Swift posted in her Instagram stories after news of the fan's death writing she has "a shattered heart."	viral_moment
Taylor Swift fan details scorching, 'sauna-like' conditions at Brazil show that left 23-year-old dead	A passionate Taylor Swift fan gave a glimpse of her experience at the chaotic Brazil concert that left a 23-year-old person dead after severe weather conditions.	miscallenous
Taylor Swift Fan Dies at Rio Concert as Fans Complain About High Temperatures and Lack of Water	RIO DE JANEIRO (AP) — A 23-year-old Taylor Swift fan died at the singer’s Eras Tour concert in Rio de Janeiro Friday night, according to a statement from the show’s organizers in Brazil.	miscallenous
Taylor Swift Fan Dies Before Eras Concert in Rio, Attendees Complain About Venue Conditions	A 23-year-old fan died at the Eras Tour concert in Rio on Friday night, according to a statement from the show's organizers in Brazil.	miscallenous
Taylor Swift postpones Rio show over "extreme weather" after fan's death	Taylor Swift postponed a concert in Rio de Janeiro, Brazil, after a 23-year-old fan died during the Friday night show of Swift's Eras Tour.	miscallenous
Patrick Mahomes approves of Travis Kelce's relationship with Taylor Swift: 'It's not become a distraction'	Chiefs quarterback Patrick Mahomes gave his stamp of approval of Travis Kelce's relationship with Taylor Swift, saying it's not a distraction to the guys in the locker room.	relationship
How to watch or stream Week 11 of the NFL’s 2023 season football live online free without cable	Here's how to watch Week 11 of the 2023 NFL season and your favorite football teams play online for free—even without a cable subscription.	unrelated
Taylor Swift postpones Rio show one day after fan's death, citing 'extreme temperatures'	Apparent temperature — a combination of temperature and humidity — hit 138 degrees Friday morning in Rio, the highest index ever recorded there.	music
Kelce Bowl' Between Chiefs, Eagles Has Some Historic Hype Behind It	The Chiefs (7-2) and Eagles (8-1) are both atop their respective conferences heading into their Super Bowl rematch.	unrelated
Taylor Swift Postpones Rio Concert Amid Safety Concerns Following Fan’s Death	Taylor Swift took to social media on Saturday evening to announce that she was postponing her concert, amid concerns over safety.	music
NFL Week 11 preview: Chiefs-Eagles headline schedule as eyes turn back to Travis Kelce, Taylor Swift	NFL fans and the pop culture world will likely be tuning in Monday night for the Kansas City Chiefs and Philadelphia Eagles, but don't count out Sunday's slate.	NFL
How Patriots coach Bill Belichick helped Josh Uche ignore the trade deadline noise	Uche credits "some open, transparent dialogue with Bill" for helping him work through hearing his name involved in trade buzz.	unrelated
How to watch the Philadelphia Eagles vs. Kansas City Chiefs game on Monday Night Football: Livestream options	A rematch of Super Bowl LVII, the Philadelphia Eagles face the Kansas City Chief and brothers Jason Kelce and Travis Kelce face off.	unrelated
How to watch the Minnesota Vikings vs. Denver Broncos NFL game: Livestream options, kickoff time, more	Watch Josh Dobbs and the Minnesota Vikings face the Denver Broncos in Week 11. Here's how to watch the game.	unrelated
How to watch today's Tampa Bay Buccaneers vs. San Francisco 49ers NFL game: Livestream options, kickoff time	The San Francisco 49ers hope to keep the winning going as they face the Tampa Bay Buccaneers. Here's how to watch.	unrelated
AMC Theatres posts best revenue and attendance since pandemic began as it closes money-losing locations and rakes in cash from 'Barbenheimer' bonanza	The mega movie theater chain has closed 156 locations since the start of the pandemic.	unrelated
How to watch or stream Thursday Night Football’s Week 10 during the 2023 NFL season live online free without cable	Here's how to watch Thursday Night Football during the 2023 NFL season online for free—even without a cable subscription.	unrelated
Taylor Swift is officially a billionaire thanks to her record-breaking tour and re-recording project, according to Bloomberg	Thanks thanks to her record-breaking Eras Tour and re-recording project, Taylor Swift has a $1.1 billion net worth, according to Bloomberg's estimates.	miscallenous
Joe Biden is taking a victory lap after the latest blowout GDP report and says the much-feared recession is canceled, but Wall Street is dubious	The Biden Administration celebrated the surge in U.S. GDP growth Thursday, but economists and analysts warn it could be the last hurrah for an ailing economy.	unrelated
How to watch or stream Week 7 of the NFL’s 2023 season football live online free without cable	Here's how to watch Week 7 of the 2023 NFL season and your favorite football teams play online for free—even without a cable subscription.	unrelated
Rooms, an interactive 3D space designer and ‘cozy game,’ arrives on the App Store	Cozy game, interior decorating app, learn-to-code primer, or something in between, the interactive, 3D spaces builder known as Rooms has made its way to the App Store. The startup, which earlier raised $10 million in seed funding led by a16z, offers a way to …	unrelated
Chipotle renames a Kansas City store in honor of Travis Kelce's old, misspelled tweet	It's spelled CHIPOLTE now, thanks to Travis Kelce.	unrelated
We need a Taylor Swift and Travis Kelce cover of Teenage Dirtbag as soon as possible	The couple sang this song by a fire pit and we need to hear it.	music
Travis Kelce appeared to be all smiles about a 'Karma is a guy on the Chiefs' sign	Travis Kelce appeared to like the "Karma is the guy on the Chiefs" sign.	unrelated
Eagles troll Travis Kelce-Taylor Swift relationship with friendship bracelet victory tweet	This is a top-tier troll from the Eagles.	relationship
Jason and Travis Kelce shared a sweet brotherly moment on the field after the Eagles defeat the Chiefs	It took five tries, but Jason Kelce finally got that win over little brother Travis.	unrelated
Did Travis Kelce make a subtle reference to Taylor Swift with his touchdown celebration during Eagles - Chiefs?	Taylor Swift might not be attending Monday night’s Kansas City Chiefs game versus the Philadelphia Eagles, but Travis Kelce may have given her a very subtle shoutout with this touchdown celeb…	miscellaneous 
Taylor Swift's parents reportedly didn't come to Chiefs - Eagles as planned	The meeting of the parents seems to be understandably postponed as Taylor Swift is still in Brazil.	miscellaneous 
NFL fans all had the same joke after Jason Kelce and D’Andre Swift walked in together for Eagles-Chiefs	This is not the Kelce-Swift duo we were expecting!	unrelated
Travis Kelce delightfully crashed the ESPN Monday Night Football pregame broadcast	Travis Kelce crashed the MNF pregame broadcast, and it was delightful.	unrelated
Taylor Swift incredibly kept performing her Eras Tour Brazil stop after breaking a heel on stage	Someone in the crowd got a very cool souvenir on the final night in Rio.	music
Travis Kelce took a playful swipe at Aaron Rodgers in his interview with The Wall Street Journal	Rodgers isn't coming back from that one.	unrelated
6 endearing things we learned about Taylor Swift from Travis Kelce's Wall Street Journal interview	Duets at bonfires? Insider help for the meeting?	relationship
The Detroit Lions are heading into Thanksgiving as one of the NFL's best teams and it's so weird	The Detroit Lions are one of the NFL's most fun teams and it's so weird to see.	unrelated
Taylor Swift won't be at Eagles - Chiefs ... but will her parents meet the Kelces?	Will Taylor Swift's parents still be at Chiefs - Eagles even if she isn't?	miscellaneous 
Billboard Music Awards 2023: Full winners list	Country titans Morgan Wallen and Taylor Swift dominated the Billboard Music Awards with a string of wins, including top artist and top Hot 100 artist.	music
Fans think this 2009 Travis Kelce tweet about college football is just so relatable	2009 Travis Kelce was just having a good time.	unrelated
The 5 most watchable NFL games for Week 11 2023, ranked	Here are the best games to watch in Week 11.	unrelated
Taylor Swift fans think Eras Tour bracelets lit up with Chiefs colors during her End Game performance	Big reputations and now gold and red bracelets!	viral_moment
The 23 most delightfully goofy Travis Kelce tweets unearthed by Taylor Swift fans	These are all so wholesome.	viral_moment
The Chiefs welcomed Taylor Swift's dad Scott to their fan base after he wore a Kansas City lanyard	The Chiefs have made their move to officially make Scott Swift one of their fans.	miscellaneous 
Donna Kelce discusses seeing The Eras Tour movie and whether Taylor Swift will be there for Chiefs - Eagles	Momma Kelce said the film adaptation of the popular tour was "amazing."	miscellaneous 
Fans speculate Travis Kelce keeps texting Taylor Swift during episodes of New Heights podcast	Honestly, if we could text Taylor Swift, we'd be doing it all the time, too.	relationship
Travis Kelce's astonishingly philosophical tweet from 2012 had Taylor Swift fans making so many jokes	When you take your first philosophy class ...	unrelated
4 Travis Kelce and Taylor Swift podcast revelations from his Argentina trip, including knowing Karma lyrics would change	Travis Kelce talked with his brother Jason on their New Heights podcast about his trip to see Taylor Swift in Argentina.	miscellaneous 
Hear Travis and Jason Kelce's delightful Fairytale of Philadelphia Christmas song duet	The Kelce brothers sound so good together.	unrelated
Will Taylor Swift fans send the Travis and Jason Kelce holiday song to No. 1?	That's right, the Kelce brothers have a holiday song coming out!	music
OK, fine, Sean Payton. Your plan to turn the Broncos around is finally working	Sean Payton is finally doing the Broncos some good.	unrelated
The Taylor Swift bowl, Victor Wembanyama vs. Chet Holmgren and more on this week's betting calendar	NFL Week 11 features a rematch of Super Bowl 57 between the Eagles and Chiefs.	NFL
Taylor Swift fans think her grateful message to Buenos Aires used one of Travis Kelce's favorite phrases	Maybe Taylor Swift already has the word “electric” in her vocabulary — heck, she has a song called Electric Touch! — to describe the die-hard crowds during the Eras Tour, bu…	music
Video shows all the times Taylor Swift sang to Travis Kelce at the Eras Tour in Argentina	Taylor Swift made sure Travis Kelce knew she was singing to him.	relationship
Taylor Swift fans remix her Travis Kelce kiss into incredibly beautiful videos	These Taylor Swift and Travis Kelce remixes are the best.	relationship
Taylor Swift and Travis Kelce will be 'engaged by May,' predicts actress Hilarie Burton	We're sure Taylor Swift fans are hoping this prediction comes true.	miscellaneous 
USA TODAY Network, Tennessean appoint inaugural Beyoncé reporter	Veteran reporter Caché McClay was chosen to cover Beyoncé's social and cultural influence for The Tennessean and the USA TODAY Network in Nashville.	unrelated
Travis Kelce's reaction to Taylor Swift changing the lyrics to Karma to be about him had fans losing it	“Karma is the guy on the Chiefs, coming straight home to me.”	relationship
Taylor Swift fans swoon over Travis Kelce’s hours-long red-eye flight to be at the Eras Tour in Argentina	Travis Kelce took an overnight flight some 5,600 miles across the globe to be there for Taylor Swift!	relationship
Taylor Swift fans think they've found Travis Kelce's plane that's headed to Argentina	Could this be Travis Kelce flying down to see Taylor Swift at the Eras Tour?	miscellaneous 
Taylor Swift's new Eras Tour pink outfits had everyone making Barbie (Taylor's Version) jokes	A changed look for Taylor Swift's latest Eras Tour stop in Buenos Aires.	miscellaneous 
Taylor Swift fans think her smile during Labyrinth as she sang 'falling in love again' is all about Travis Kelce	Was Taylor Swift singing a message to Travis Kelce during the Eras Tour? Fans think so.	music
Travis Kelce had a really good reason for missing Taylor Swift's first Eras Tour show in Argentina	Travis Kelce was in Kansas City for an important event while Taylor Swift kicked off her first show in Argentina.	relationship
NC State football perfectly invoked Taylor Swift for Payton Wilson's postseason awards campaign	This is a winning combo.	NFL
Dry Swifties or Wet Swifties? This Buenos Aires weather report (Taylor's version) is too funny	The buzz is high in Argentina with the Eras Tour starting back up.	miscellaneous 
NBA refs ejected Giannis Antetokounmpo against the Pistons for the most pathetic reason	It's always great when officials make the game about themselves, isn't it?	unrelated
6 signs Taylor Swift's Reputation (Taylor’s Version) could be dropping soon, according to fans	Could there be any truth to these fan theories about Swift's latest re-release?	miscellaneous 
Travis Kelce will travel to Taylor Swift's Eras Tour stop in Argentina, per multiple reports	Multiple reports say Travis Kelce is headed down to Buenos Aires for Taylor Swift's Eras Tour stop there.	relationship
Peyton Manning and Luke Bryan hysterically roasted the Jets with a CMA Awards joke involving Taylor Swift	Jets fans might want to avoid this one.	awards
Jason Kelce says 'I’m not even the sexiest man in my family' after People's Sexiest Man Alive feature	We assume Jason Kelce is referring to Travis Kelce here.	unrelated
Don't let Travis Kelce distract you from Jason Kelce being among People's Sexiest Men Alive	Excuse me, Travis Kelce, but Jason Kelce must be protected AT ALL COSTS.	unrelated
Travis Kelce hints at flying to Taylor Swift's Eras Tour stop in Argentina in latest podcast ep	Could Travis Kelce be implying he's flying south to Argentina to see Taylor Swift for her Eras Tour stop?	relationship
5 wildest NFL betting moments (so far) this season, including Patrick Mahomes' slide	There have been plenty of bad beats so far this NFL season.	unrelated
Taylor Swift reportedly hosted wives of Travis Kelce's teammates at a Chiefs watch party	Wives of Travis Kelce's teammates were seen leaving Swift's Tribeca home on Sunday.	miscellaneous 
The Giants' Daniel Jones era probably just came to a whimpering end with his latest injury	Losing your job to injury is tough. It's about to happen to Daniel Jones.	unrelated
NFL Week 9 takeaways: Strange QB matchups make for odd results	The NFL quarterback carousel spun out of control on Sunday, with seven teams making a change at the position from the previous week.	unrelated
Taylor Swift hangs with Brittany Mahomes, Sophie Turner in NYC: Photos	Taylor Swift was spotted hanging out in New York City on Saturday with friends Selena Gomez, Brittany Mahomes, Sophie Turner and Gigi Hadid.	miscellaneous 
Travis Kelce won't say if Taylor Swift will be in Germany and jokingly blames oddsmakers for it	Those pesky oddsmakers always getting in the way	relationship
Why Travis Kelce and the Chiefs are playing in Germany in Week 9, explained	Here's the answer.	unrelated
Taylor Swift fans want to know why Travis Kelce isn't in the Chiefs' latest TikTok	AN INVESTIGATION: The Chiefs are playing checkers while the Swifties are playing chess.	miscellaneous 
Mike McDaniel hilariously could not accept that kids were dressing up as him for Halloween	Easily the funniest coach in the NFL.	unrelated
16 best celebrity costumes for Halloween 2023, including Paris Hilton as Britney Spears	Not to be dramatic, but some of these are truly iconic.	unrelated
NFL Week 8 Awards: Brock Purdy is showing his haters they were all absolutely right	Brock Purdy's critics were correct. He's a system player AND he stinks.	unrelated
Chiefs fan Morgan Freeman has no interest in Travis Kelce and Taylor Swift’s love life	Morgan Freeman said what he said.	miscellaneous 
Jack Black shamelessly belting out Taylor Swift lyrics in his underwear is glorious	Jack Black is a legend for this.	miscellaneous 
Will Taylor Swift keep going to Travis Kelce's games? Let's look at their schedules	Let's look at the Eras Tour schedule and the Chiefs' slate of games to see if we'll see more Swift at his games.	relationship
10 outrageous Dolly Parton covers that don't exist but definitely should exist	There's nothing Dolly can't do.	unrelated
NFL fans debated whether or not Josh Allen called a ‘Taylor Swift’ audible or a ‘J.R. Smith’ audible	Did Josh Allen say "Taylor Swift" or "J.R. Smith" with this TNF audible call?	NFL
Taylor Swift fans are convinced 1989 (Taylor’s Version) could be a double album, and they might be right	Are the Swifties on to something here?	music
Taylor Swift fans aren't going to be happy with Terry Bradshaw's Eras Tour lip sync theory	Taylor Swift fans might have some beef with Terry Bradshaw over this one.	miscellaneous 
The Texas Rangers' run to the World Series is everything we love about sports	The Rangers are doing things the right way and it's so fun to watch	unrelated
Taylor Swift is officially a Chiefs fan thanks to the way she sings the national anthem	Taylor Swift is just like every Chiefs fan now.	music
The Eagles' Tush Push doesn't need to be banned. Other teams just need to stop it	Don't ban the tush push. Just get a stop.	unrelated
Travis Kelce fist-pumps after a ‘Taylor Swift’s boyfriend’ cheer from an enthusiastic fan	Kelce can add one more title to his long list of accolades.	relationship
Taylor Swift's best outfits at Chiefs games, ranked: A running tally of what she's worn to watch Travis Kelce	Breaking down the best Taylor Swift fits at Chiefs games.	miscellaneous 
Taylor Swift fans all made the same joke about her and Travis Kelce riding a golf cart to an afterparty	Riding in a getaway car(t).	miscellaneous 
What's behind the extreme heat wave in Brazil that forced Taylor Swift to postpone a show	Thousands of Taylor Swift's fans in Brazil have braved extreme heat to watch the singer perform on her wildly popular "Eras Tour."	miscellaneous 
GOP rising star Mark Robinson’s wretched Facebook feed lands him in trouble ... again	North Carolina’s lieutenant governor, a rising star in the GOP, appears to have posted comments on Facebook quoting Hitler and minimizing the Holocaust.	unrelated
The Philadelphia Eagles' signature 'tush push' is effectively driving its critics mad	Philadelphia and Jalen Hurts beat the Miami Dolphins on Sunday. The Eagles' only crime with its "brotherly shove" is making football fourth downs less dramatic.	unrelated
Lionel Messi draws Brazilian fans to what could be his last match in Rio	Many Brazilians have become fans of Lionel Messi in recent years, and his potentially last game in Brazil is drawing many local fans.	unrelated
Eagles vs. Chiefs live updates: Top moments from Monday Night Football	Week 11 of the 2023 NFL season comes to a close Monday with the Eagles facing the Chiefs. Here are the top moments!	unrelated
What Travis Kelce, Patrick Mahomes, more are saying about Taylor Swift	Several people close to Travis Kelce expressed their thoughts on his relationship with Taylor Swift ahead of Monday's Chiefs-Eagles tilt.	relationship
Eagles hope their new safety has the secret to stopping Travis Kelce	Can anyone slow Travis Kelce? New Eagles safety Kevin Byard will look to try to do just that in Monday's rematch of Super Bowl LVII.	unrelated
Buccaneers are on a 3-game skid, but still have a lot to play for this season	Tampa Bay has lost three straight and fallen out of the NFC South lead, but the middle of the NFL is wide open, and playoff contention requires them to be good, not great.	unrelated
Buffalo Bills made a philosophical change with Josh Allen in win, but is it sustainable?	The Buffalo Bills got Josh Allen more involved in the running game. It gave them a spark, but is it sustainable?	unrelated
What we learned in NFL Week 7: Lamar Jackson as MVP frontrunner; Travis Kelce's immense value	Lamar Jackson is an MVP frontrunner, Travis Kelce showed why he's as valuable to his team as any pass-catcher in the NFL — and that's just a small part of what we learned in Week 7.	unrelated
Sportsbooks win big via Patriots upset; college bettors fall flat with USC loss	Sportsbooks won big in NFL Week 7, as the Patriots' shocking outright win over the Bills blew up parlays, Patrick Everson reports.	unrelated
Sportsbooks win big in NFL Week 7 thanks to Patriots upset of Bills; college bettors also lose with USC	Sportsbooks won big in NFL Week 7 as the Patriots' upset of the Bills blew up parlays, and USC losing to Utah was bad for bettors, Patrick Everson reports.	unrelated
NFL top-10 rankings: Chiefs hold top spot; Eagles, Ravens rise; Dolphins, Lions fall	Kansas City stays No. 1, but the rest of the rankings are a jumble as the Eagles and Ravens fly high while the Dolphins and Lions regroup.	unrelated
Eagles defense smothers Dolphins' electric attack in impressive win	Philadelphia's defense shut down the NFL's most dangerous offense, showing the Eagles have many ways to beat anyone they play.	unrelated
P.J. Locke saves Denver from another meltdown as Broncos beat Packers 19-17	The Broncos blew a 16-3 lead but ultimately ended a dubious streak in which they had lost 10 consecutive games when leading at halftime.	unrelated
Despite three red-zone fumbles, Falcons still beat Bucs to grab first place	Both teams struggled near the goal line, but Atlanta hit a field goal as time expired to beat the Bucs and move into first place in the NFC South.	unrelated
Browns edge Myles Garrett dominates in win over Colts: 'Man, 95 is a problem'	Myles Garrett's Sunday: nine tackles, two sacks, two forced fumbles, a pass breakup and a blocked field goal. Oh, and the Browns won 39-38.	unrelated
LeBron James to clap back at Nuggets' trash talk? 'There will be a time'	With the Los Angeles Lakers and Denver Nuggets' season opener around the corner, LeBron James weighed in on all the trash talk he has absorbed.	unrelated
Canada’s economy faces $900-billion mortgage renewal shock	The biggest shock awaits variable-rate mortgages set to renew in 2026. A five-year variable mortgage renewing in October of that year would see payments jump 76 per cent if mortgage rates stayed around 6 per cent	unrelated
Shelter aid sticking points		unrelated
Let's be clear about what 'dark money' is		unrelated
Guy's night out		unrelated
Migrant crisis comes to a head		unrelated
Biden world sinks its claws into Phillips	And Vice President Kamala Harris is in London this morning ahead of the kickoff of the big Global AI Safety Summit	unrelated
The phantom menace		unrelated
Playbook: New speaker, new attitude	And the White House rebuked a comparison of Israel to Russia.	unrelated
Ballot questions put to an early test		unrelated
We found a way': Hurts' take on Eagles-Chiefs leads NFL's top Week 11 quotes	From the Chargers' head coach getting feisty to a Broncos safety defending his now-suspended teammate, NFL Week 11 action provided an abundance of memorable quotes.	unrelated
How Patriots coach Bill Belichick helped Josh Uche ignore the trade deadline noise	Uche credits "some open, transparent dialogue with Bill" for helping him work through hearing his name involved in trade buzz.	unrelated
Hype Trap Bet: Joshua Dobbs' case for Comeback Player of the Year	Joshua Dobbs has taken the league by storm. Kevin Pulsifer analyzes his chances to win Comeback Player of the Year as the underdog story of the 2023 season.	unrelated
Why football in Premier League and Europe is anything but a fair fight	It's not surprising that big teams with lots of resources and money might win more trophies -- just look at Man City's dominance in recent seasons -- but what might surprise you is the sheer scale of this inequality.	unrelated
The NFL's stalled running back market, three months later: Barnwell on what's next for the position	Let's check in with eight running backs who dominated the conversation in the offseason. Are they living up to expectations?	unrelated
The late-night dive to rescue the Bedlam goalposts after Oklahoma State's historic win	Hours after Oklahoma State took down rival OU in their final matchup, a few Cowboys fans went hunting for a piece of Bedlam history.	unrelated
Kelce: Chiefs have every piece needed to be great	The Chiefs heading into Sunday's game against the Dolphins haven't been an offensive power like in previous seasons. But tight end Travis Kelce said that's not because the Chiefs are deficient at wide receiver.	unrelated
Mike Clay's NFL Betting Playbook for Week 9	Mike Clay pits his projection system against the sportsbooks with a game-by-game look at Week 9 player props, offering his leans for taking the over or the under.	unrelated
You're a wizard, Harry': Notable trends from Diamondbacks' last World Series win	Some of the top Arizona Diamondbacks' players were just infants the last time Arizona made the World Series in 2001.	unrelated
Hype, Trap, Bet: How to handle the Michigan scandal	Kevin Pulsifer looks at a tumultuous Wolverines program that's somehow heading in opposite directions at the same time.	unrelated
Union Berlin are no longer an underdog fairytale, but they're worth rooting for	Union Berlin's players couldn't believe the support of their home fans as their losing streak stretched to nine games on Tuesday night. But that's what makes this club, and its supporters, so special.	unrelated
Underdogs bite betting public on big Sunday for sportsbooks	The betting public took a big hit on Sunday after two popular underdog teams failed to live up to expectations. David Purdum breaks it all down.	unrelated
Trump Is Still Obsessed With the ‘Golden Showers’ Rumor	Most of us have stopped thinking about the fabled ‘pee tape,’ but Donald Trump won’t let us forget it. He told Iowa rallygoers that Melania didn’t believe the golden showers story, though nobody asked.	unrelated
Fabian Basabe Will Not Be Canceled	Fabian Basabe, the party boy turned Miami GOP politico, fights off sexual harassment claims by male staffers and plots his future. (His wife stands by him.)	unrelated
This AI Quiz Will Turn Your Life Into A Taylor Swift Song In Like, 15 Seconds	I'm all ears...View Entire Post ›	miscallenous
Just 43 Things That’ll Be Super Easy To Wear With Stuff You Already Own	Because sometimes you just need the right pants to go with a certain top.View Entire Post ›	unrelated
55 Unexpected Gifts That'll Put Santa To Shame	Commemorative Taylor Swift tickets, Renaissance cat calendars, Love Island tumblers, and tons of other fun items your giftee had no idea they needed.View Entire Post ›	unrelated
34 Beauty Products With Before And Afters That’ll Seriously Wow You	Your jaw is gonna drop when you see what the biotin shampoo could do for you.View Entire Post ›	unrelated
The "22" Hat Taylor Swift Gives Away Every Night On Tour Costs Almost $400, Plus 26 Other BTS Facts About Her Eras Tour Wardrobe	Taylor's 16 costume changes involve wayyy more Swarovski crystals than you might think!View Entire Post ›	miscallenous
36 Incredible Products I Think About Even More Than Taylor Swift And Travis Kelce (And I Think About Them A *Lot*)	I look at this $5 holy grail mascara the same way Trav looks at Taylor.View Entire Post ›	relationship
Reviewers Swear By These 28 Makeup Products Under $25	From setting spray to a top-rated brow pencil, get the most bang for your buck with these reviewer-loved makeup must-haves.View Entire Post ›	unrelated
Taylor Swift Went Out With A Large Group Of Famous Girlfriends, And It's Just Looking Worse And Worse For Joe Jonas	I imagine them doing some sort of Hocus Pocus hexing spell while eating the biggest ball of burrata you've ever seen.View Entire Post ›	miscallenous
A Reporter Asked Travis Kelce The Status Of His Relationship With Taylor Swift, And Fans Love His Response	Travis is keeping his cards close to his chest.View Entire Post ›	relationship
46 Beauty Products That Really And Truly Solve Problems	We're human, we have problems — but these products will make them ( poof) ~disappear~.View Entire Post ›	unrelated
If You’re Always Running Late, Here Are 43 Products To Help You Get Back Some Time In Your Day	Including a sunrise alarm clock that will wake you up gradually so you don't have to hit snooze 15 times.View Entire Post ›	unrelated
41 Pieces Of Clothing And Shoes For Anyone Who Has Been Wearing Black Long Before Wednesday Addams	Your closet will be dancing like Wednesday after you finish shopping this post.View Entire Post ›	unrelated
Here's What People Are Saying After Kelly Clarkson Responded To Claims She "Bashed" Taylor Swift And Travis Kelce	"Do not fall prey to clickbait, trash reporters twisting the facts again."View Entire Post ›	relationship
41 Things That'll Make You Want To Start Writing Your Holiday Wish List Now	A monthly book subscription, a soft serve maker, Taylor Swift-inspired embroidered sweatshirts, and more great things you'll want to add to your own holiday wish list this season.View Entire Post ›	miscallenous
Feds Subpoena Ticketmaster Over Egregious Concert Prices After It 'Stonewalled' Lawmakers	A spokesperson for Live Nation, which owns Ticketmaster, said the firm doesn't “feel comfortable” sharing information with Congress.	unrelated
iPad Kids Are Getting Out of Hand	Millennials are raising "bizarre and terribly behaved” children, glued to screens. Can Gen Z flip the script?	unrelated
House may consider Mayorkas impeachment this week	The House may consider a resolution this week that aims to impeach Homeland Security Secretary Alejandro Mayorkas after a push by Rep. Marjorie Taylor Greene (R-Ga.) to do so, according to the chamber’s schedule of measures it plans to consider. The Mayorkas …	unrelated
Shiffrin turns page on busy off-season, begins pursuit of record-tying 6th overall World Cup title	Keeping up with Mikaela Shiffrin's off-season endeavours may be just as challenging as catching up to her in a ski race. She's constantly full speed ahead.	unrelated
Eagles couldn’t help themselves by making a Taylor Swift reference after win over Chiefs	The Philadelphia Eagles are celebrating their win on “Monday Night Football” against the Kansas City Chiefs with an apparent nod to Travis Kelce’s relationship with Taylor Swift.	relationship
Taylor Swift’s Rio tour marred by deaths, muggings and a dangerous heat wave	Taylor Swift's three-day leg of her eras tour in Rio de Janeiro, Brazil was marred by the deaths of two people, extreme heat and muggings and crime, as fans decried on social media.	music
Nikki Haley's abortion messaging and X sues Media Matters: Morning Rundown	OpenAI employees threaten to leave after CEO Sam Altman's ouster.	unrelated
Jalen Hurts leads second-half rally as Eagles beat Chiefs 21-17 in Super Bowl rematch	The Philadelphia Eagles rallied from a 10-point halftime deficit to beat the Kansas City Chiefs 21-17 in a Super Bowl rematch Monday night.	unrelated
Taylor Swift concert runs into brutal Brazilian heat wave	The death of a Taylor Swift fan at her recent concert in Rio de Janeiro comes during a brutal heat wave that has hammered parts of Brazil.	music
Biden confuses Taylor Swift with Britney Spears in remarks on his 81st birthday	President Joe Biden mixed up Taylor Swift and Britney Spears in remarks Monday during the White House’s annual turkey pardoning ceremony, which happened to fall on the president’s 81st birthday.	miscallenous
Taylor Swift Rio concert chaos: Fans describe ‘unbearable' Friday show	Fans in Rio de Janeiro waited years for Taylor Swift to come to their city. When she finally did, “everything that could have gone wrong did," one fan said.	music
Biden to celebrate his 81st birthday pardoning Thanksgiving turkeys	President Joe Biden will be spending his 81st birthday Monday carrying out an annual White House tradition: pardoning two lucky turkeys.	unrelated
How Taylor Swift transcends America's political divides — barely	Pop star Taylor Swift notched the highest net favorability ratings of any figure tested in the latest NBC News national poll.	awards
Biden and Xi announce new agreements and mother of 6-year-old who shot teacher sentenced: Morning Rundown	Chinese president Xi Jinping and President Joe Biden find common ground.	unrelated
How Taylor Swift and Travis Kelce are inspiring people to raise their dating standards	It’s a love story that people just want to say yes to: Taylor Swift and Travis Kelce — who have been rumored to be dating since September — are inspiring people to step up their own dating expectations.	relationship
Taylor Swift asks fans not to throw objects on stage	Taylor Swift asked fans at her Buenos Aires concert on Sunday night to not throw objects on stage, saying “it really freaks me out.”	music
Gaza's main hospital 'no longer functioning' and Tim Scott suspends campaign: Morning Rundown	Get everything you need to know to start your day. Sign up to get the Morning Rundown newsletter to your email inbox.	unrelated
Taylor Swift cancels Friday night show in Buenos Aires after Travis Kelce arrives in Argentina	Taylor Swift called off her Friday night Eras Tour show in Buenos Aires due to intense rain even after Travis Kelce showed up to watch her perform.	music
Taylor Swift makes Grammy Awards history with most song of the year nominations	Taylor Swift made history when the nominations for 2024 Grammy Awards were announced on Friday. The music superstar became the first person to be nominated in the song of the year category seven times.	awards
Taylor Swift delights Argentina concert fans with popular Spanish slang	Taylor Swift fans went wild in Argentina when she swapped the words "like ever" for a Spanish expression popular in Argentina, and the crowd went wild.	music
Taylor Swift's headed to Argentina for her Eras Tour — Travis Kelce plans to be there, too	Taylor Swift has been on the sidelines rooting Travis Kelce on while he works, and now, he's expected to travel to Argentina as her Eras Tour resumes.	relationship
Taylor Swift’s Eras Tour concert film takes its final bow at the box office this weekend	Taylor Swift takes her final bow at the movie box office this weekend.	music
NewJeans says they’re more than solely K-pop stars as they break global barriers	NewJeans is reflecting on being the first K-pop girl group to be nominated for the “Top Billboard Global (Excl. U.S.) Artist” award.	unrelated
Halloween 2023: A look at the viral moments that inspired people's costumes this year	Many online are sharing their Halloween costumes that were inspired by viral moments, pop culture trends and iconic internet memes.	unrelated
Chiefs lose, Travis Kelce has a tough day in Taylor Swift's absence	High-profile tight end Travis Kelce underperformed against expectations Sunday in the Kansas City Chiefs' loss to the Denver Broncos — and his reported sweetheart, Taylor Swift, wasn't there to see it.	relationship
‘1989 (Taylor’s Version)’ is coming. Here’s what to know.	‘1989 (Taylor’s Version)’ features vault tracks: “Now That We Don’t Talk,” “Suburban Legends,” “Say Don’t Go,” “Is It Over Now?” and “‘Slut!’”	unrelated
Taylor Swift kisses Travis Kelce on the cheek in Instagram photo	Taylor Swift and Travis Kelce are getting just a little bit more cozy in a new snap that has fans buzzing.	relationship
Taylor Swift wears friendship bracelet with Travis Kelce’s jersey number at Chiefs-Chargers game	Taylor Swift might be the Kansas City Chiefs’ good luck charm.	relationship
Taylor Swift's Eras Tour linked to unfortunate circumstances in Rio, including fan deaths and dangerous heat	Taylor Swift's Eras Tour has been marred by the deaths of fans, muggings and a dangerous heat wave in Rio de Janeiro. On Friday, a fan fell ill during the show and later died.	music
‘Hunger Games’ prequel tops box office with $44 million opening in North America	The "Hunger Games" prequel, "The Hunger Games: The Ballad of Songbirds & Snakes" has brought in an estimated $44 million in ticket sales at the North American box office.	unrelated
Taylor Swift suffers wardrobe malfunction on stage during Brazil 'Eras Tour' stop	Taylor Swift's heel broke off during the "Lover" set of "The Eras Tour" in Brazil. The "Midnights" singer took the stage Monday night for a rescheduled show following "extreme" weather.	music
Donna Kelce regrets calling Taylor Swift 'okay' in interview, says son Travis is 'happier' in life	Travis Kelce's mom, Donna Kelce, apparently has regrets over how she answered a question about Taylor Swift, but her son assured her she handled it perfectly.	relationship
Taylor Swift's beau Travis Kelce details their courtship; Sami Sheen reveals she had a boob job	The Fox News Entertainment newsletter brings you the latest Hollywood headlines, celebrity interviews and stories from Los Angeles and beyond.	relationship
Tom Brady rips 'mediocrity in today’s NFL,' takes issue with 'product' on the field	Tom Brady expressed his frustration with what he's been seeing on the NFL field and the officiating. He made his comments on the "Stephen A. Smith Show."	unrelated
Chiefs' Marquez Valdes-Scantling drops go-ahead TD pass, smashes helmet in frustration	Kansas City Chiefs wide receiver Marquez Valdes-Scantling dropped a key pass late in their loss against the Philadelphia Eagles. The catch would have been the go-ahead score.	unrelated
Travis Kelce breaks scoreless drought but key fumble contributes to Chiefs loss sans Taylor Swift	Travis Kelce made an impact early for the Kansas City Chiefs, but key mistakes stymied the team in their narrow loss to the Philadelphia Eagles.	relationship
Sofia Vergara admits divorce contributed to 'interesting and very difficult' year	Sofia Vergara admitted that she had a "very interesting" and "very challenging" year following her divorce from her husband of 7 years, Joe Manganiello.	unrelated
Biden’s birthday present: Abysmal polls and growing concern about his age	As President Biden's foreign policy blunders mount, the Democratic base grows weary in their enthusiastic support of the 81-year-old president.	unrelated
Biden's Taylor Swift-Britney-Beyoncé mix-up sparks social media mockery: 'This is an impeachable offense'	President Biden appeared to confuse pop singers Britney Spears, Beyoncé and Taylor Swift during his comments at the annual turkey pardon at the White House on Monday.	miscallenous
Biden mocked after confusing pop music stars during turkey pardoning joke: 'Impeachable offense'	Social media users piled on President Biden after he botched a joke Monday that appeared to be targeting young voters due to their enthusiasm for the pop music stars.	miscallenous
Coddling in college: ‘Helicopter parents’ use Facebook groups to arrange playdates, warn about non-vegan food	A growing number of parents are using WhatsApp and Facebook groups to help assist their children away at college, arranging "playdates," haircuts and more.	unrelated
Travis Kelce admits he thinks about retirement 'more than you can imagine'	Kansas City Chiefs tight end Travis Kelce has no intentions of hanging up his NFL cleats, but he admitted in an in-depth profile that he thinks about retirement nonstop.	unrelated
Taylor Swift's boyfriend Travis Kelce finally reveals how they met: 'She'll probably hate me for saying this'	Taylor Swift's boyfriend Travis Kelce is sweetly spilling all the details about how he and the popstar first started dating, and he gave kudos to her inner circle.	relationship
Super Bowl champ dishes on Taylor Swift effect on NFL: 'I think it makes it fun'	New York Giants legend weighed in on the Taylor Swift effect on the NFL amid her relationship with Kansas City Chiefs superstar Travis Kelce.	relationship
Biden cracks age joke on 81st birthday, then confuses Taylor Swift, Beyonce	President Biden, who turned 81 today, made jokes about his age during the White House turkey pardon before mixing up Taylor Swift and Beyonce in a remark.	miscallenous
Taylor Swift gets emotional on stage performing song 'Bigger Than the Whole Sky' after fan's death	Taylor Swift appeared to pay tribute to a fan who died before her Eras tour performance on Friday in Rio de Janeiro, Brazil, after the city faced a heat wave.	music
Eagles troll Travis Kelce ahead of major Monday night matchup	The Philadelphia Eagles may have given the Kansas City Chiefs some bulletin board material ahead of Monday night's matchup. They took aim at Travis Kelce.	unrelated
Taylor Swift returns to Rio stage after postponing Eras Tour concert, fan death	Taylor Swift resumed The Eras Tour in Brazil after canceling concert on Nov. 18 due to record heatwave across Rio. One fan died Friday after fainting outside stadium.	music
Patrick Mahomes approves of Travis Kelce's relationship with Taylor Swift: 'It's not become a distraction'	Chiefs quarterback Patrick Mahomes gave his stamp of approval of Travis Kelce's relationship with Taylor Swift, saying it's not a distraction to the guys in the locker room.	relationship
NFL Week 11 preview: Chiefs-Eagles headline schedule as eyes turn back to Travis Kelce, Taylor Swift	NFL fans and the pop culture world will likely be tuning in Monday night for the Kansas City Chiefs and Philadelphia Eagles, but don't count out Sunday's slate.	relationship
Taylor Swift postpones Brazil concert due to 'extreme temperatures'	Taylor Swift announced that her Saturday night Eras concert in Rio de Janeiro has been postponed due to "extreme temperatures."	music
Taylor Swift fan details scorching, 'sauna-like' conditions at Brazil show that left 23-year-old dead	A passionate Taylor Swift fan gave a glimpse of her experience at the chaotic Brazil concert that left a 23-year-old person dead after severe weather conditions.	music
Taylor Swift’s dad gets apology from Travis Kelce; Will Smith, Jada Pinkett Smith deny cheating claims	The Fox News Entertainment newsletter brings you the latest Hollywood headlines, celebrity interviews and stories from Los Angeles and beyond.	miscallenous
Taylor Swift ‘devastated’ as fan dies before Brazil concert	A Taylor Swift fan died before her opening night concert in Rio de Janeiro, Brazil, Friday. Swift shared a statement on her social media mourning the loss of the fan.	music
Taylor Swift hints Travis Kelce romance is serious with these subtle clues	Taylor Swift has dropped subtle clues about her relationship with Travis Kelce. Her fans have picked up on hints the romance is getting serious during The Eras Tour.	relationship
Philadelphia radio station says it won't play Taylor Swift songs ahead of Eagles-Chiefs Super Bowl rematch	The Kansas City Chiefs host the Philadelphia Eagles Monday night, and a Philly radio station is banning Taylor Swift songs until after the game.	miscallenous
Drew Barrymore doesn't want plastic surgery: 'I worry I'd continue to chase it'	Drew Barrymore says that she's never had plastic surgery and doesn't picture herself getting any, saying her "highly addictive personality" might cause her to go overboard.	unrelated
Trolls 3' director taps into NSYNC fever, 90s nostalgia in latest installment of hit series	The director of "Trolls 3" reflects on how his film's NSYNC reunion melted millennial hearts and why the famed boy band's music continues to resonate decades later.	unrelated
Taylor Swift honored on Christ the Redeemer statue: 'Welcome to Brazil'	Taylor Swift was honored with a projection on Brazil's Christ the Redeemer statue of a shirt inspired by the superstar's "Junior Jewels" shirt from her "You Belong With Me" music video.	music
Kelce' becomes a top trending dog name in America, pet company's data shows	Recent data from Rover has shown that a top trending dog name in America right now is "Kelce," amid coverage of the Kansas City Chiefs player and girlfriend Taylor Swift.	relationship
Michigan's Jim Harbaugh agrees to serve 3-game ban, Big Ten drops sign-stealing investigation	Michigan coach Jim Harbaugh agreed to serve a 3-game suspension over the school's sign-stealing scandal and the Big Ten has dropped its investigaton.	unrelated
3 ways to increase your privacy and save money when booking travel	Kurt "CyberGuy" Knutsson takes on protecting privacy and saving money while booking travel plans through the use of creating an email alias.	unrelated
DC pro-Palestinian protest turns violent, Senate averts shutdown, passes funding bill and more top headlines	Get all the stories you need-to-know from the most powerful name in news delivered first thing every morning to your inbox.	unrelated
Taylor Swift, Travis Kelce's long distance romance has fans anticipating next rendezvous	Taylor Swift embarks on Brazilian leg of her Eras Tour this week through Thanksgiving, leaving little time for new romance with boyfriend Travis Kelce.	relationship
JESSE WATTERS: The chemistry between Biden and Xi was unmistakable	Jesse Watters highlights how President Biden cozied up to president Xi during their meeting in San Francisco on "Jesse Watters Primetime."	unrelated
Taylor Swift tour may prevent Thanksgiving at home with Travis Kelce	Taylor Swift's first Thanksgiving with Travis Kelce may be over FaceTime as she continues Eras Tour in Brazil while he plays football with Kansas City Chiefs.	relationship
Patriots legend Rob Gronkowski says Mac Jones should ask for release now: 'He's not respected'	Mac Jones' tenure with the New England Patriots has hit rock bottom at 2-8 in his third season, and legend Rob Gronkowski believes he should ask for his release now.	unrelated
Brady Bunch' star Barry Williams, 69, shocks 'DWTS' crowd by ripping off shirt: 'I'm gonna chuckle forever'	Brady Bunch' star Barry Williams, 69, reflected on his "Dancing with the Stars" experience with Fox News Digital as he exits the competition after being eliminated.	unrelated
Travis Kelce issues apology to Taylor Swift's dad Scott after concert flub	Travis Kelce spilled on his trip to Argentina to visit girlfriend Taylor Swift and hilariously apologized to her father, Scott, for an awkward flub he made during the concert.	relationship
Taylor Swift, Travis Kelce meet the parents: Who's who in each famous family	As Taylor Swift and Travis Kelce's relationship continues to grow, they have been spotted spending time with each other's parents, who appear to be supportive of the romance.	relationship
Travis Kelce, Taylor Swift budding relationship draws wholesome remark from Andy Reid	Kansas City Chiefs head coach Andy Reid remarked on Travis Kelce's relationship with Taylor Swift as he spent his bye week in Argentina to see the pop star.	relationship
Taylor Swift surprises Travis Kelce at concert, pleads with fans to stop throwing things on stage	The Fox News Entertainment newsletter brings you the latest Hollywood headlines, celebrity interviews and stories from Los Angeles and beyond.	relationship
Taylor Swift jokes about witchcraft, 'never beating the sorcery allegations' after crazy concert moment	Taylor Swift is poking fun at long-standing rumors that she is a witch, sharing a bizarre moment from her Argentina shows that points to that narrative.	miscallenous
Taylor Swift, Travis Kelce's PDA signals NFL player is 'endgame' for pop star: expert	Taylor Swift and Travis Kelce took their relationship public during the "Karma" singer's "Eras Tour" with new lyrics and a kiss. Experts explain the change in Swift's stance on privacy.	relationship
Bills penalty results in heartbreaking loss after Broncos get second chance at game-winning field goal	The Denver Broncos sealed the deal against the Buffalo Bills, 24-22, on Monday night after getting another chance to kick a game-winning field goal following a Bills penalty.	unrelated
SNL's Hamas joke in Timothée Chalamet skit infuriates pro-Palestinian voices online	A "Saturday Night Live" skit that included a joke about Hamas infuriated pro-Palestinian voices over the weekend, who said it made light of "genocide."	unrelated
US professors use pop culture icons like Taylor Swift and Rick Ross to make law school more engaging	Law professors across the U.S. are incorporating pop culture icons like Taylor Swift and Rick Ross into their courses in an effort to engage students.	miscallenous
Taylor Swift pleads with fans after item is thrown onstage during Eras Tour concert: ‘It really freaks me out’	After objects were thrown onstage, Taylor Swift politely asked her audience in Argentina to refrain, as it endangers her dancers and scares her.	music
Young Taylor Swift played a song backstage for Britney Spears during 'Oops! ... I Did it Again' tour	Britney Spears reflected upon meeting a young Taylor Swift, before she was famous, at her own "Oops! ... I Did It Again" tour. Spears says Swift played her a song on the guitar.	miscallenous
Taylor Swift runs to kiss Travis Kelce after he attends her second Eras show in Argentina	Taylor Swift and Travis Kelce shared a kiss after the singer rushed into the NFL star's arms following her second Eras tour concert in Argentina.	relationship
Taylor Swift postpones Argentina concert after Travis Kelce arrives	Taylor Swift canceled the Nov. 10 concert of the international leg of "The Eras Tour" due to "chaotic" weather. Her rumored boyfriend, Travis Kelce, just arrived in the country.	music
Taylor Swift fans go wild as she sings about 'falling in love again' while kicking off international tour	Taylor Swift shocked fans Thursday by singing about "falling in love again" amid her romance with NFL star Travis Kelce. The pop star performed "Labyrinth" in Buenos Aires for the first time on her Eras Tour.	music
GREG GUTFELD: Hillary Clinton's interview on 'The View' shows she's still 'hung up' on Trump	FOX News host Greg Gutfeld reacts to Hillary Clinton's Trump focused interview on "The View" on "Gutfeld!"	unrelated
Mom told to remove decorations from son's gravesite — plus Taylor Swift 'swear jar' goes viral	The Fox News Lifestyle Newsletter brings you trending stories on family, travel, food, neighbors helping neighbors, pets, autos, military veterans, heroes, faith and American values.	viral_moment
Travis Kelce will travel to Argentina to see Taylor Swift's 'Eras Tour': report	Kansas City Chiefs tight end Travis Kelce is going to use the bye week to reportedly head down to Argentina in support of Taylor Swift's "Eras Tour" beginning international stops.	relationship
2023 CMAs co-hosts Luke Bryan, Peyton Manning joke about Taylor Swift, Travis Kelce at award show	The 2023 CMA Award co-hosts, Luke Bryan and Peyton Manning, took a moment during the show to make a Taylor Swift, Travis Kelce joke. Manning also poked fun at the New York Jets.	awards
Couple's viral 'Taylor Swift Jar' has wife paying a quarter whenever she mentions the star	A Maryland realtor and her husband went viral after a "Taylor Swift Jar" was made. If someone mentions Swift or Travis Kelce, a quarter is required to be added to the jar.	viral_moment
Chiefs' Travis Kelce hints at traveling to South America to support Taylor Swift's tour during team's bye week	During a recent podcast episode, two-time Super Bowl champion Travis Kelce played coy about potentially traveling to South America to take in one of Taylor Swift's Eras Tour shows.	relationship
Taylor Swift & Brittany Mahomes party before Chiefs game, King Charles' reported control over Harry & Meghan	The Fox News Entertainment newsletter brings you the latest Hollywood headlines, celebrity interviews and stories from Los Angeles and beyond.	miscallenous
Taylor Swift supports Travis Kelce with rare social media move	Taylor Swift liked an Instagram post about Travis Kelce's performance from his game in Germany on Sunday, sending fans into a frenzy over the public act of support.	relationship
Giants' Daniel Jones suffers torn ACL, season likely over for star QB	New York Giants quarterback Daniel Jones will miss the rest of the season as Brian Daboll announced he tore his ACL in Sunday's game against the Las Vegas Raiders.	unrelated
Travis Kelce faces jabs after another quiet game without Taylor Swift in attendance	Kansas City Chiefs tight end Travis Kelce faced some ribbing on social media as he had another quiet game with Taylor Swift not in attendance.	relationship
Chiefs' wild fumble-return sequence leads to improbable touchdown vs Dolphins	A wild fumble return helped the Kansas City Chiefs take a comfortable lead into halftime against the Miami Dolphins in Germany on Sunday.	unrelated
Can Republicans flip New Jersey’s state legislature from blue to red?	New Jersey Republicans face a tough challenge Nov. 7, with Democrats in control of both chambers of state government and the governor's office	unrelated
Travis Kelce asked if he's 'in love' with Taylor Swift, addresses relationship 'status'	Travis Kelce and Taylor Swift are all but officially official, which prompted a reporter in Germany to ask the Chiefs star if he's "in love."	relationship
Travis Kelce's mom explains why Chiefs star has taken game to 'new level' amid Taylor Swift relationship	Travis Kelce's relationship with Taylor Swift led some to believe he wouldn't perform well for the Chiefs this season, but his mother, Donna Kelce, explained why it motivates him more.	relationship
Travis Kelce plays into joke that Taylor Swift 'put me on the map'	Travis Kelce is getting in on the joke that Taylor Swift put him "on the map." The narrative even inspired a couple's Halloween costume, which Kelce "enjoyed."	relationship
Donna Kelce talks NFL's new viewership due to Taylor Swift's presence: 'I'm sure they're extremely happy'	Donna Kelce, the mother of Jason and Travis Kelce, discussed how she believes the NFL feels with Taylor Swift's presence at Kansas City Chiefs games resulting in boosted ratings.	relationship
Diet Coke-obsessed mom from Kentucky reveals her viral collection and 'the joy it brings me'	A viral Diet Coke lover from Kentucky — a mom named Beth Sturgill — has come forward to share her soft drink memorabilia; it's all found inside her Lexington home. See the pix!	unrelated
Kelly Clarkson ripped her pants while filming 'Since You've Been Gone' music video: ‘I was commando’	Kelly Clarkson revealed that she ripped her pants while filming the music video for "Since You've Been Gone," when speaking to Kyle Richards.	unrelated
Travis Kelce faces criticism from Chiefs great for World Series attendance: 'Let this be a lesson'	Kansas City Chiefs great Nick Lowery took issue with Travis Kelce making an appearance at the World Series before the team was in Denver and lost to the Broncos.	unrelated
Taylor Swift skips Travis Kelce's football games for Eras Tour prep	Taylor Swift has been a staple at Travis Kelce's Kansas City Chiefs games as of late, but she missed a recent game to focus on her upcoming Eras Tour stops in South America.	relationship
Fox News Politics: The next ambassador to Israel	The latest updates from the 2024 campaign trail, exclusive interviews and more Fox News politics content	unrelated
Taylor Swift, Travis Kelce Halloween costume wins friends a top prize: See their rendition of the stars	Florida friends dressed up as Taylor Swift and Travis Kelce for a Halloween costume contest and took home the grand prize. See the pair mimick the iconic duo!	viral_moment
NJ Gov Phil Murphy used thousands in taxpayer funds to party at Taylor Swift concert, stadium events: report	New Jersey Gov. Phil Murphy reportedly spent nearly $12,000 in taxpayer funds at MetLife stadium since 2018, including at a Taylor Swift concert.	miscellaneous
‘Five Nights at Freddy’s’ dominates Halloween weekend with $78 million debut in North America	The simultaneous release of "Five Nights at Freddy's" in theaters and on streaming had little impact on the film's success on the big screen Halloween weekend.	unrelated
Broncos troll Chiefs by blasting Taylor Swift hit throughout the stadium after major upset	The Denver Broncos had a little fun at the expense of Chiefs' star Travis Kelce after they defeated Kansas City on Sunday for the first time since 2015.	NFL
Literary legend haunted hotel for 53 years until neglected remains buried with family in NYC, say historians	The ashes of American literary icon Dorothy Parker reportedly haunted the Algonquin Hotel for more than 50 years, before she was buried beside family in New York City.	unrelated
Matthew McConaughey, Sharon Osbourne, Helena Bonham Carter share ghost stories: 'Something weird happened'	Sharon Osbourne, Matthew McConaughey, Helena Bonham Carter, Lily Collins and Megan Mullally share their stories of ghosts and hauntings.	unrelated
AJ Brown sets NFL record as Eagles use second-half surge to beat Commanders	Philadelphia Eagles star wide receiver A.J. Brown was back dazzling everyone on Sunday as he broke the NFL record for most 125-plus receiving yards in six straight games.	unrelated
Halloween candy vs. healthy parenting: Here's how to make it all work	Parenting is hard, especially with candy companies trying turn Halloween into an all-year sugar-buzz festival. We can help them grow without ruining their childhoods.	unrelated
Chiefs star Travis Kelce dances to Taylor Swift's 'Shake It Off' at World Series game	The Kansas City Chiefs star broke out some dance moves to one of Taylor Swift's hit songs during his appearance at Game 1 of the World Series between the Rangers and Diamondbacks.	NFL
Jennifer Lawrence's full-frontal nude scene; Morgan Wallen looks for love	The Fox News Entertainment newsletter brings you the latest Hollywood headlines, celebrity interviews and stories from Los Angeles and beyond.	unrelated
Taylor Swift to likely miss Travis Kelce's Chiefs game this Sunday as 'Eras Tour' nears return: reports	The Grammy Award winning singer has become a fixture at Chiefs home and road games so far this season, where she has supported Travis Kelce from luxury suites.	NFL
Patrick Mahomes wants to 'one-up' Taylor Swift and his wife's handshake with Travis Kelce	When Taylor Swift and Patrick Mahomes' wife went viral for their two handshakes, the quarterback realized he didn't have one with Travis Kelce.	miscellaneous
Taylor Swift releases reimagined '1989' album, reviving nostalgia during new era of career	Taylor Swift has released her reimagined "1989" album. The original album marked the beginning of her singing career's shift from country to pop and now is being revisited.	music
US strikes Iran-linked sites in Syria, elite border unit joins hunt for Maine suspect and more top headlines	Get all the stories you need-to-know from the most powerful name in news delivered first thing every morning to your inbox.	unrelated
Taylor Swift embraced by Travis Kelce's Kansas City Chiefs crew: 'She's letting her guard down,' expert says	Taylor Swift has been welcomed like "family" into Travis Kelce's Kansas City Chiefs crew, according to a body language expert who analyzed the pop star's moves with her new friends.	NFL
Rob Gronkowski says NFL is overdoing it with Taylor Swift coverage during games: ‘We want more football’	Rob Gronkowski thinks the NFL is giving Taylor Swift “too much" screen time during games and says the league should “show the players" more.	NFL
Taylor Swift and Travis Kelce relationship works because ‘they’re very supportive of each other,’ his dad says	Taylor Swift will soon release her next re-recorded album, and Travis Kelce's dad will be in line to purchase as he boasted that the "Cruel Summer" singer is "very genuine."	relationship
Eagles' Jason Kelce expresses concern for brother Travis Kelce amid budding romance with Taylor Swift	Jason Kelce is "happy" for brother Travis Kelce amid his budding romance with pop sensation Taylor Swift, but he does have one possible concern.	relationship
GOP confident Johnson will be speaker, Biden megadonor criticized for tech board seat and more top headlines	Get all the stories you need-to-know from the most powerful name in news delivered first thing every morning to your inbox.	unrelated
Taylor Swift, Travis Kelce break NFL WAG curse: Jessica Simpson, Carrie Underwood once blamed for losses	Taylor Swift and Travis Kelce's new relationship fills the blank space that the NFL needs to recover from the alleged curse when Hollywood stars date football players.	NFL
In time for Halloween, Washington driver caught in HOV lane with creepy clown dummy and assessed scary ticket	A driver was caught by the Washington State Patrol in the high-occupancy vehicle lane with a creepy Halloween clown tied to the passenger seat.	unrelated
NFL Player on RB Contract Debate: 'If I Was Ever a GM, I Would Never Pay a RB'	It's not only NFL general managers who don't want to hand out big-money contracts to running backs. In a player survey conducted by The Athletic, one player…	unrelated
Fantasy Football Week 11: Examining Trade Value for This Year's Top 100 Players	Let's be honest—if you are reading this, your fantasy team probably isn't good enough to win a title and you are scouring the trade market, hoping to fleece…	unrelated
Fantasy Football Week 10: Updated Trade Value for Top 100 Players	There have been so many injuries in the NFL—especially at the quarterback position—that patching together a fantasy lineup has probably felt like attempting…	unrelated
Cowboys vs. Eagles Draws 27.1M Viewers, Most-Watched NFL Game of 2023 Season	Sunday's thrilling contest between the Dallas Cowboys and Philadelphia Eagles did massive numbers for Fox. According to Fox Sports public relations, the…	unrelated
Eagles' Jason Kelce to Feature in People Magazine's 2023 'Sexiest Man Alive' Edition	Philadelphia Eagles center Jason Kelce will be featured in People magazine's upcoming Sexiest Man Alive issue. People revealed six men, including Kelce, who…	unrelated
NHL Style Rankings: B's, Canadiens Continue Rivalry off Ice; A Legend Goes Shirtless	Remember two weeks ago, during the first installment of the third season of the OG NHL Style Rankings, when I said the guys were off to a slow fashion start…	unrelated
Fantasy Football Big Board: Complete 2023 PPR Player Rankings for Week 9	It's Week 9 of the 2023 fantasy football campaign. We're past the halfway point, but not quite at the stretch run. Call it "last chance" time. Sure, there are…	unrelated
Fantasy Football Big Board: Complete 2023 PPR Player Rankings for Week 8	Well folks, we're halfway home. Seven weeks into the 2023 fantasy football season, we've hit the midway point. It's a half-season that has gone very…	unrelated
Patrick Mahomes, Travis Kelce Excite Fans as Chiefs Beat Justin Herbert, Chargers	The Kansas City Chiefs earned their sixth straight win Sunday thanks to historic outings by two of the team's star players. Quarterback Patrick Mahomes topped…	unrelated
Taylor Swift's Rio de Janeiro tour scarred by deaths, muggings, heat-related illnesses	The deaths of two people, heat-related illnesses and other misfortunes have left legions of Taylor Swift fans angry and disappointed in the three-day Rio de Janeiro leg of the pop superstar’s Eras Tour	music
Kelce Bowl: Chiefs' Travis, Eagles' Jason the center of attention in a Super Bowl rematch	You can’t go anywhere these days without hearing or seeing something that has to do with Eagles center Travis Kelce and his younger brother and Chiefs tight end Travis Kelce	unrelated
What to stream this week: 'Oppenheimer,' Adam Sandler as a lizard and celebs dance to Taylor Swift	This week’s new entertainment releases include Adam Sandler playing a 74-year-old elementary class lizard in the latest Netflix animation offering “Leo” and “Oppenheimer” finally arriving on home screens	miscellaneous
A noisy rock 'n' roll': How growing interest in Formula One is felt across the music world	Beyond the engineering, the athleticism, the speed, the luxury, fans love the sound of Formula One	unrelated
2024 Grammy nomination snubs and surprises: No K-pop, little country and regional Mexican music	With new categories, “Barbie” and SZA — there’s a lot to discuss regarding the 2024 Grammy Award nominations	unrelated
Partial list of nominees for the 66th Grammy Awards	The nominees for next year's Grammy Awards have been announced	unrelated
Movie Review: Nicolas Cage finds fame to be highly overrated in chillingly funny ‘Dream Scenario’	Nicolas Cage, perhaps best known for his onscreen volatility, takes a fascinating swerve to play a mundane, schlubby, balding professor at nowhere famous in Kristoffer Borgli's “Dream Scenario.”	unrelated
Court arguments begin in effort to bar Trump from presidential ballot under 'insurrection' clause	Court arguments are beginning in the effort to bar former President Donald Trump from running for his old job again	unrelated
Court arguments begin in effort to bar Trump from presidential ballot under 'insurrection' clause	Court arguments are beginning in the effort to bar former President Donald Trump from running for his old job again	unrelated
From country to pop, 2014 nostalgia to 2023 reality — it's time for Taylor Swift's '1989'	Taylor Swift’s reimagined “1989” is here, the album that ushered in the first Peak Swift era — revisited at the height of her massive pop culture dominance	top_chart
Country musician Megan Moroney says she writes sad songs for sad people. It's making her a star.	Not so long before her platinum single “Tennessee Orange” became inescapable on country radio, Megan Moroney was attending the University of Georgia	unrelated
Chiefs' Travis Kelce has been taking his play to a new level with Taylor Swift in the house	Kansas City Chiefs tight end Travis Kelce has been taking his play to a new level whenever Taylor Swift is in the house	relationship
What to stream this week: '1989 (Taylor’s Version),' Emily Blunt and 'Five Nights at Freddy’s'	This week’s new entertainment releases include Taylor Swift's “1989 (Taylor’s Version),” a glossy look at opioid addiction with the movie “Pain Hustlers” starring Emily Blunt, Chris Evans and Andy Garcia, and the streaming horror flick “Five Nights at ...	top_chart
Swift bests Scorsese at box office, but 'Killers of the Flower Moon" opens strongly	In a movie match-up almost as unlikely as “Barbie” and “Oppenheimer,” Martin Scorsese took on Taylor Swift in cinemas over the weekend	top_chart
NFL Week 7 recap: Bill Belichick gets 300th regular-season win; Hurts rebounds to lift Eagles over Dolphins	Mac Jones threw a 1-yard touchdown pass to Mike Gesicki with 12 seconds remaining to lift the New England Patriots to a 29-25 win over the Buffalo Bills on Sunday, making Bill Belichick the third coach in NFL history with…	unrelated
Restored iPod models are selling out at retailers after only a year of being discontinued	Urban Outfitters is selling restored fifth generation iPods to Gen Z – and they're selling like hotcakes.	unrelated
Brazil has recorded its hottest temperature ever, breaking 2005 record	Brazil recorded its hottest-ever temperature on Sunday, as thermometers in the small city of Araçuaí hit 112.6 Fahrenheit.	unrelated
Taylor Swift's parents to meet Travis and Jason Kelce's for first time at Eagles-Chiefs game: report	Taylor Swift's parents to meet Travis and Jason Kelce's for first time at Eagles-Chiefs game: reportcbsnews.com	relationship
How to watch tonight's San Francisco 49ers vs. Minnesota Vikings game on Monday Night Football	The Vikings will try for a Minnesota Miracle to score their first win over the San Francisco 49ers since 2018.	unrelated
How to watch today's Atlanta Falcons vs. Tampa Bay Buccaneers game: Livestream options, Week 7 schedule, more	The Tampa Bay Buccaneers look to bounce back in a Week 7 divisional matchup against the Atlanta Falcons.	unrelated
How to watch today's Pittsburgh Steelers vs. Los Angeles Rams game	Aaron Donald and the LA Rams face Kenny Pickett and the Pittsburgh Steelers today. Here's how to watch.	unrelated
NFC showdown: How to watch today's Arizona Cardinals vs. Seattle Seahawks game	It's going to be tough for the Arizona Cardinals to beat the Seattle Seahawks at home, but this Cardinals squad is full of surpises.	unrelated
How to watch today's Miami Dolphins vs. Philadelphia Eagles game: Livestream options, kickoff time	Two 5-1 teams face off for the game of Week 7 when the Miami Dolphins hit the road vs the Philadelphia Eagles.	unrelated
How to watch today's Cleveland Browns vs. Indianapolis Colts game: Kickoff time, livestream options, more	Deshaun Watson is expected to return for the Cleveland Browns' Week 7 game against the Indianapolis Colts.	unrelated
How to watch today's Buffalo Bills vs. New England Patriots game: Livestream options, kickoff time, more	The Bills are 6-1 against the Tom Brady-less Patriots, but over confidence could send the Bills home with a loss.	unrelated
Jason Kelce Knew Travis Was 'Beating Himself Up Pretty Good' After MNF Loss	The Eagles star got his first NFL win over his younger brother, who struggled through a frustrating game for the Chiefs.	unrelated
Kellyanne Conway's Daughter Backs Campaign to Oust Harry Jowsey From 'DWTS'	Claudia Conway showed support for a campaign to see Jowsey eliminated from "DWTS"—and the reason is all about Taylor Swift.	unrelated
Video of Patrick Mahomes, Wife Brittany's Kiss Goes Viral	"She made him sleep on the sofa after the game," joked one football fan.	unrelated
How Taylor Swift and Travis Kelce's First Meeting Unfolded	The Kansas City Chiefs tight end revealed he had "someone playing Cupid" on Taylor Swift's team.	relationship
Jason Kelce, D'Andre Swift Execute Elite 'Swift Kelce' Troll Before MNF	Jason Kelce and D'Andre Swift walked out of the tunnel together before the Eagles took on the Chiefs on Monday.	unrelated
Travis Kelce Crashed ESPN's Monday Night Football Set (and Had Mic Issues)	The Kansas City Chiefs star seemed excited and ready for the Super Bowl rematch against the Eagles and his brother Jason.	unrelated
Kelce Bowl:' 5 Facts About Jason, Travis Kelce as Eagles, Chiefs Face Off	The Chiefs (7-2) host the Eagles (8-1) at 8:15 p.m. ET in a prime-time "Monday Night Football" showdown and Super Bowl rematch.	unrelated
Caesars Sportsbook Promo Code for MNF: Use NEWSWK1000 to Get $1,000 Bet	Caesars Sportsbook promo code NEWSWK1000 will unlock a $1,000 first bet for Eagles-Chiefs on Monday Night Football.	unrelated
Here's the Real Threat from AI Right Now (Just Ask My Son)	A content farm used AI to write the author's biography. Most of it was wrong.	unrelated
Jason Kelce Came Into Her Hot Dog Restaurant and 'Tried To Roast the Queen'	The Eagles center made a good impression on employees at Wiener's Circle, including resident trash-talker Poochie Rollins.	unrelated
Patrick Mahomes Joining ESPN's ManningCast After Failed 'Audition' For Show	The Kansas City Chiefs quarterback was featured in an Omaha Productions skit with Peyton and Eli Manning over the summer.	unrelated
Josh Dobbs Isn't a Just Viral Story, He's a Valuable Lesson for Sports Fans	While the Vikings quarterback has become the talk of the NFL over the past couple of weeks, he's more than just a feel-good story.	unrelated
Biden Gets Bad Economic News as Polls Spell Disaster	Consumers expect inflation to be high in 2024 just as President Joe Biden will be seeking re-election.	unrelated
Brittany Mahomes' Skims Ad Sparks Backlash	Brittany and Patrick Mahomes star in a campaign for Kim Kardashian's Skims clothes brand ahead of the holidays.	unrelated
Harry Styles Made a Big Change and Fans Are Shaken	Fans have taken to X, formerly known as Twitter, to share their heartbreak over the singer's shock decision.	unrelated
Jason Kelce (Not Travis) Named One of People's Sexist Men Alive	The Philadelphia Eagles center told the publication he and his family are "just trying to have fun" as his fame soars.	unrelated
Donald Trump's January 6 Choir Comes Back To Haunt Him	Special prosecutor Jack Smith says that Trump's use of recordings of the choir at campaign rallies shows that he is glorifying the Capitol riot.	unrelated
Rob Schneider Under Fire Over Travis Kelce Comment	"Not true just more lies," one person wrote, while another added: "Not sure Travis knows who Rob even is."	unrelated
Dolly the Disruptor: The Queen of Country's Barrier-Breaking Milestones	A timeline of Dolly Parton's iconic career—when she pioneered the pop-country crossover, paved the way for female artists and showed the world compassion wins.	unrelated
Exclusive: Dolly Parton on Rock, Rhinestones and Her Genre-Busting Career	The queen of country talks to Newsweek about her new rock album, iconic style and music industry breakthroughs: 'I just do what my heart tells me."	unrelated
Mike Johnson Has Already Made His First Mistake	Speaker Johnson has caused controversy by demanding an IRS funding cut in return for aid to Israel.	unrelated
Americans Are Earning More Even as They Complain About the Economy	Wages are rising, but Americans still feel the economy is headed in the wrong direction.	unrelated
Bills QB Josh Allen Probably Did Not Call a 'Taylor Swift' Audible	Astute fans watching the Thursday Night Football broadcast heard Josh Allen call an audible, but did he say "Taylor Swift" or "J.R. Smith?"	NFL
Travis Kelce Goes Viral for Bizarre Game Behavior	A video of Travis Kelce barking at a Los Angeles Chargers player during the game on Sunday has gone viral, with fans divided over the footage.	unrelated
Lamar Jackson Leads the Best Performers of Week 7 in the NFL	Quarterbacks took the stage again this week, leading their teams to victory.	unrelated
NFL Week 7 Winners and Losers: Eagles Slow Down Dolphins Offense in SNF Win	The Eagles managed to mostly contain the top-ranked Dolphins offense in a 31-17 win on Sunday Night Football.	unrelated
The KC Chiefs Have a Ready-Made Insurance Policy for Nick Bolton's Injury	While seeing starting linebacker Nick Bolton go down injured isn't ideal, the Kansas City Chiefs are well positioned to cope with his absence.	unrelated
Travis Kelce Salary: How Much Does the Chiefs Tight End Make?	Travis Kelce is sitting squarely in the center of the pop-culture spotlight. Have you ever wondered about his earning power with the Chiefs?	unrelated
TIME’s Top 100 Photos of 2023	Did you see this photo??*link*Wow.Omg!! Follow this exchange with a dynamic discussion, hit repeat, and you have a pretty accurate snapshot of the TIME photo department’s typical Slack conversations. Even though we collectively scroll through thousands of pho…	unrelated
Pink to kick off 2024 UK tour in Cardiff	The singer says she's looking forward to helping celebrate 25 years of the Principality Stadium.	unrelated
Brazil records its hottest ever temperature	The town of Araçuaí in the country's southeast hit a high of 44.8C (112.6F) on Sunday.	unrelated
Robbie Williams fan dies after fall at Sydney concert	The woman in her 70s slipped and fell down six rows of seats, suffering serious head injuries.	unrelated
Taylor Swift appears out of breath at Rio concert	Video showed the singer gasping for air in between songs during her performance in the stifling heat.	music
Taylor Swift postpones Rio de Janeiro concert after death of fan	The US pop star says she is putting safety first after temperatures in the Brazilian city reached 39.1C.	music
Taylor Swift 'devastated' as fan dies before show	The pop star gave out water bottles to fans during the concert in Brazil, amid sweltering heat.	music
The Beatles' hits albums denied number one (again)	The Fab Four's hopes of correcting a historic blip in their chart record are dashed by Taylor Swift.	music
Taylor Swift gets 'heavenly' welcome from Christ the Redeemer	The famous statue in Rio de Janeiro is illuminated as the global pop sensation arrives on her Eras tour.	miscellaneous 
NFL star Jason Kelce tops iTunes chart with new Christmas hit	The NFL star joined his brother Travis Kelce to reimagine the Christmas hit Fairytale of New York.	unrelated
Cardiff City Stadium to host Welsh rugby's Judgement Day	Welsh rugby's Judgement Day derby URC double-header will be held at Cardiff City Stadium on 1 June.	unrelated
Harry Styles haircut reveal in Vogue lights up debate	The former One Direction star confirms his famous mop top is History - and fans have strong thoughts.	unrelated
Aria Awards: Troye Sivan wins big and Kylie Minogue wins with Padam Padam	Kylie Minogue wins with Padam Padam at the Aria Awards, whilst Troye Sivan takes home four awards.	unrelated
The Las Vegas GP - a plan 40 years in the making	F1 is going all out to make an impression in Las Vegas, but what's the background to what promises to be an iconic race?	unrelated
Taylor Swift adds two more Wembley dates to Eras tour, equalling Take That record	The pop star adds two extra nights to her Eras tour, and matches a Wembley record set by Take That.	music
The Marvels: Superhero movie bombs with lowest MCU box office debut	"This opening is an unprecedented Marvel box office collapse," says box office analyst David A Gross.	unrelated
The Beatles top singles chart 60 years after their first hit	Sir Paul McCartney says their final song Now and Then reaching the top spot has "blown my socks off!"	unrelated
Grammy Awards 2024: The main nominees	Taylor Swift, Olivia Rodrigo, Miley Cyrus and SZA are among the nominees at the 2024 ceremony.	award
Grammy Awards 2023: Taylor Swift breaks nomination record	Swift has become the first songwriter to receive seven song of the year nominations.	top_chart
TfW travel: New rail line for major Cardiff events axed	Public money has been lost on the project, which would have improved travel to major Cardiff events.	unrelated
Chiefs & Dolphins set for 'electric' Germany clash	The NFL returns to Germany with a mouth-watering match-up between defending champions the Kansas City Chiefs and the in-form Miami Dolphins.	unrelated
Taylor Swift’s 1989 re-recording scores record-breaking UK chart debut	A re-recorded version of Swift’s 2014 pop opus more than doubles the first-week sales of the original.	top_chart
Jung Kook's Golden: BTS star crowned 'pop king' by critics thanks to solo album	Critics say the star's solo debut is "pop bliss" and he has "punched his ticket to pop superstardom".	unrelated
Singer Weyes Blood: I feel like I've lived a million lives	The ethereal singer-songwriter and "pagan time travel tourist" on making music for a changing world.	unrelated
Taylor Swift and Barbie take over this Halloween	From Utah to Massachusetts, pop culture references have turned this year’s spooky season pink.	miscellanious
FNaF movie: Halloween box office records broken by Fazbear gang	Critics weren't keen on the game adaptation, but fans helped the film rack up monster ticket sales.	unrelated
Taylor Swift not buying Notts County, football club confirms	The owners of the League Two outfit say they are sorry to "disappoint the Swifties in our fanbase".	NFL
Taylor Swift: Artist paints the star on giant Halloween pumpkin	It took Ohio-based Jeanette Paras 10 hours to create the artwork.	miscellanious
Taylor Swift's 1989: Why has she re-recorded it and what's new on Taylor's Version?	How does Taylor's Version of the hit album compare to the original, and why has she re-recorded it?	music
Glastonbury Festival: Emily Eavis lines up 'really big' US artist for 2024	Organiser Emily Eavis says one 2024 headliner is almost in the bag, and she'd love Madonna to play.	unrelated
Johnny Cash's 'Blank Space' Is Why AI Can't Have Nice Things	With covers of Taylor Swift and “Barbie Girl” going viral, Johnny Cash is suddenly the voice of AI. The choice is telling.	unrelated
Taylor Swift and Beyoncé Are Resurrecting the American Movie Theater	This week, as “Swifties of the Flower Moon” took over social media, Swift trounced Martin Scorsese at the US box office. Beyoncé’s tour film is coming later this fall. Cinema is back, baby!	miscellanious
Fan dies at Taylor Swift Eras Tour concert in Brazil with record heat	A 23-year-old woman succumbed to heat as Taylor Swift brought her Eras Tour to a concert venue in Rio de Janeiro.	music
The 31 best things to do in D.C. this weekend and next week	Get in the holiday spirit with holiday markets, light displays and Scrooge; celebrate Community Day at Planet Word; or browse works by hundreds of artists.	unrelated
Fake celebrity statements and videos on Israel-Hamas war — and other news literacy lessons	From the non-partisan News Literacy Project.	unrelated
Sorry, Jane Austen, but Mr. Darcy is actually the worst	According to English professor Rachel Feder, the romantic hero of ‘Pride and Prejudice’ has set us up to love men who treat us like dirt.	unrelated
‘Fingernails’: A form of cinematic torture	Jessie Buckley, Jeremy Allen White and Riz Ahmed star in a silly, sci-fi story of a love triangle.	unrelated
12 can’t-miss concerts in the D.C. area this November	Ice Spice and Doja Cat at Capital One Arena; Benny the Butcher at Howard Theatre; Liz Phair at the Anthem.	unrelated
Third quarter GDP shows U.S. economy grew at a blockbuster 4.9 percent pace	Third quarter GDP shows U.S. economy grew at a blockbuster 4.9 percent pacewashingtonpost.com	unrelated
Hunger Games’ director feels bad about his 45-minute song pitch for Olivia Rodrigo	The Ballad of Songbirds & Snakes director Francis Lawrence explains his 45-minute rant to Olivia Rodrigo. “Can’t Catch Me Now” is streaming now.	unrelated
Concert movies are the future of pop music fandom	Taylor Swift, BTS, and Beyoncé’s concert movies level the field for fans. Once considered secondary to live shows, filmed concerts are now essential to fandom.	miscellanious
Taylor Swift was the soundtrack to my Killers of the Flower Moon screening	Did you hear Taylor Swift: The Eras Tour while trying to watch Martin Scorsese’s latest movie? You aren’t alone.	miscellanious
Taylor Swift’s Rio Tour Marred by Deaths, Muggings and a Dangerous Heat Wave	RIO DE JANEIRO — The deaths of two people, muggings and a dangerous heat wave left legions of Taylor Swift’s Brazilian fans angry and disappointed in the three-day Rio de Janeiro leg of the pop superstar’s Eras Tour, which concludes Monday night.	music
Joe Biden Makes Bizarre Joke at Turkey Pardoning, Confuses Taylor Swift and Britney Spears	President Joe Biden made a bizarre, confusing joke during this year's annual turkey pardoning ceremony at the White House, seemingly referencing Taylor Swift's sweltering concert in Brazil, which tragically resulted in the death of one fan, but also mentionin…	miscellanious
Rio de Janeiro Officials Project Taylor Swift Welcome onto Famed 'Christ the Redeemer' Statue	Officials in Rio de Janeiro were so excited about pop star Taylor Swift's imminent concerts in Brazil that they electronically projected a Swifty-themed robe onto its famed Christ the Redeemer statue that overlooks the glittering city.	music
Taylor Swift Fan Dies at Rio Concert as Fans Complain About High Temperatures and Lack of Water	RIO DE JANEIRO (AP) — A 23-year-old Taylor Swift fan died at the singer’s Eras Tour concert in Rio de Janeiro Friday night, according to a statement from the show’s organizers in Brazil.	music
Taylor Swift Promoted Left-Wing Voter Registration Organization While Remaining Silent on Hamas' Massacre of Israelis	Mega pop star Taylor Swift used her massive social media following to promote a left-wing voter registration organization on election day. But the singer continues to remain silent on Hamas' massacre of Israelis more than a month after the October 7 slaughter.	miscellanious
Taylor Swift Calls on Fans to Hit the Polls Ahead of Major Elections in Several States	Pop star Taylor Swift, the jet-setting climate change activist who endorses Democrats, attacks Republicans, and performs for Communist human rights abusing-China’s Singles Day, took to social media on Tuesday to encourage her fans in certain states to vote on…	miscellanious
VIDEO: Broncos Troll Chiefs, Travis Kelce by Playing Taylor Swift Music After Upset Win	The Broncos trolled the Chiefs by playing Taylor Swift music after their upset win over Kansas City on Sunday.	NFL
We Want More Football!!!': Rob Gronkowski Says Networks Overdoing Taylor Swift Coverage	Former Super Bowl champ Rob Gronkowski think that broadcast network's should focus less on Taylor Swift and more on the players on the field.	NFL
Google sues people who “weaponized” DMCA to remove rivals’ search results	Google says DMCA fraudsters filed copyright takedown notices for 600,000+ URLs.	unrelated
A remote worker explains why she stands by the controversial practice of working from movie theaters	A viral video of a remote worker using a movie theater as an office has divided viewers. But she stands by her take that it's a great place to work from.	unrelated
Naming a species after a celebrity may do more harm than good	Many species were named in honor of famous people and celebrities. But species names are difficult to change and may lead to nomenclatural regret.	miscellanious
Far-right hosts are blaming the GOP's big election losses on Taylor Swift	Right-wing activist Jack Posobiec and commentator Charlie Kirk both blamed Taylor Swift's political power for electoral losses.	miscellanious
Taylor Swift achieves billionaire status amid monumental Eras tour	According to a Bloomberg News Analysis published Thursday, Taylor Swift's net worth is $1.1 billion.	top_chart
Taylor Swift: Friend Cara Delevingne says Swift and Travis Kelce’s relationship is ‘very different’	Taylor Swift: Friend Cara Delevingne says Swift and Travis Kelce’s relationship is ‘very different’cnn.com	relationship
Taylor Swift set to perform rescheduled Rio show after deadly heat | CNN	Taylor Swift will wrap up her “Eras Tour” concerts in Rio de Janeiro, Brazil on Monday, following a weekend of shows beset by dire heat and tragedy.	music
Travis Kelce is ready to talk about dating Taylor Swift | CNN	There was a time when Travis Kelce wasn’t interested in talking about his personal life, but no more.	relationship
The enduring allure of Louboutin’s red soles	In the 30 years since the inception of the brand’s red sole, Louboutin has perhaps done more than any other to transform a piece of footwear into an objet d’art.	unrelated
Taylor Swift postpones Eras Tour concert in Rio de Janeiro due to heat	Taylor Swift announced that her concert scheduled for Saturday in Rio de Janeiro, Brazil has been postponed due to high temperatures.	music
Taylor Swift mourns fan who died before concert in Brazil | CNN	Taylor Swift fan died Friday night before the Eras Tour show in Rio De Janeiro, Brazil the singer said on Instagram.	music
5 things to know for Nov. 17: Trump agenda, Israel, Safe schools, George Santos, Apple | CNN	5 things to know for Nov. 17: Trump agenda, Israel, Safe schools, George Santos, Apple | CNNcnn.com	unrelated
Travis Kelce apologizes to Taylor Swift’s dad | CNN	Remember when Travis Kelce said he was going to stick to talking about football and not his private life? Good thing for the Swifties it looks like he didn’t mean it.	relationship
Taylor Swift ‘Dancing With the Stars’	Taylor Swift ‘Dancing With the Stars’cnn.com	music
Travis Kelce sings on brother’s Christmas song | CNN	Travis Kelce sings on brother’s Christmas song | CNNcnn.com	unrelated
Taylor Swift concert postponement prompts airline to waive change fee | CNN	LATAM Airlines waived its change fees for customers who wanted to extend their stay in Buenos Aires, Argentina, after Taylor Swift postponed her concert there.	music
Taylor Swift changes lyrics to ‘Karma’ in nod to ‘guy on the Chiefs’ Travis Kelce | CNN	Taylor Swift winked at her romance with Kansas City Chiefs’ tight end Travis Kelce during her “Eras Tour” concert in Buenos Aires, Argentina on Saturday when she changed the lyrics to a line in her hit song “Karma,” and Kelce was in the audience to catch it.	relationship
Taylor Swift reschedules ‘Eras Tour’ performance	Taylor Swift reschedules ‘Eras Tour’ performancecnn.com	music
Grammy nominations 2024: See the full list of nominees | CNN	Nominations for the 2024 Grammy Awards will be revealed on Friday morning.	unrelated
Americans say the economy stinks. But they’re spending like it’s great | CNN Business	There’s a conundrum that economists and political strategists have been chewing on for more than a year: The economy is good, but Americans say it’s lousy.	unrelated
5 things to know for Nov. 7: Trump trial, Israel, Presidential debate, Actors strike, Ukraine | CNN	5 things to know for Nov. 7: Trump trial, Israel, Presidential debate, Actors strike, Ukraine | CNNcnn.com	unrelated
Taylor Swift reporter hired at Gannett after viral job listing | CNN	Consider journalist Bryan West the “lucky one,” because he’s The Tennessean and USA Today network’s new Taylor Swift Reporter.	viral_moment
Taylor Swift adds Brittany Mahomes to her squad | CNN	Taylor Swift adds Brittany Mahomes to her squad | CNNcnn.com	music
Taylor Swift’s ‘1989 (Taylor’s Version)’ is her 13th album to hit No. 1 on Billboard charts	Taylor Swift continues to break records in her whirlwind year, with “1989 (Taylor’s Version)” hitting No. 1 on the Billboard 200 album charts. It’s the singer’s 13th No. 1 album.	top_chart
Taylor Swift and Beyoncé concert tours deliver record-breaking earnings for Live Nation	Live Nation has Taylor Swift and Beyoncé to thank for propelling the live concerts organizer to its strongest quarterly results to date.	top_chart
Ice Spice turns heads in Betty Boop Halloween costume	Ice Spice has shown the world what she’s working with in her latest Halloween costume — and she wasn’t afraid to let it all hang out.	unrelated
5 things to know for Oct. 27: Maine shootings, Israel, US strikes, Hurricane Otis, Presidential race | CNN	5 things to know for Oct. 27: Maine shootings, Israel, US strikes, Hurricane Otis, Presidential race | CNNcnn.com	unrelated
Taylor Swift releases ‘1989 (Taylor’s Version)’ | CNN	Straight out of your “wildest dreams,” Taylor Swift just dropped “1989 (Taylor’s Version).”	music
Taylor Swift is now a billionaire, Bloomberg says | CNN Business	Taylor Swift has another accolade to add to her already impressive resume this year: America’s favorite pop star is now a billionaire, according to a Bloomberg analysis.	top_chart
5 things to know for Oct. 23: Israel, House speaker, Synagogue leader, Police shooting, Student loans	5 things to know for Oct. 23: Israel, House speaker, Synagogue leader, Police shooting, Student loanscnn.com	unrelated
Taylor Swift is still in her (Chiefs) Red era with latest appearance supporting Travis Kelce at football game | CNN	In a surprise to absolutely nobody, Taylor Swift was back in Kansas City on Sunday to support Travis Kelce at his football game.	relationship
Why the latest temperature check on climate change is still terrifying	The United Nations Environment Programme (UNEP) released its latest estimates for future global warming ahead of climate change negotiations in Dubai.	unrelated
Do Pixel 8 AI-edited photos have to be labeled as synthetic content on YouTube? YouTube is still figuring it out.	The new Pixel 8 can swap facial expressions in photos using AI. YouTube’s new rules require labels on AI-generated content. What happens next?	unrelated
Taylor Swift fans used record amounts of data during the Eras Tour in North America	A staggering 29 terabytes of glitter moved through AT&T’s network during her stop in Arlington, Texas, and Swifties set data usage records almost everywhere else.	miscellanious
Scarlett Johansson hits AI app with legal action for cloning her voice in an ad	Scarlett Johansson is taking legal action against an AI app developer for using her likeness in an online ad without her consent.	unrelated
Harvard professor Lawrence Lessig on why AI and social media are causing a free speech crisis for the internet	The internet policy legend is as worried as you’d think about AI and TikTok.	unrelated
The View' hosts see red flags in Travis Kelce's Taylor Swift interview	The View' hosts discussed the 'red flags' they saw in Travis Kelce's recent interview about dating Taylor Swift, and called the NFL star a 'palate cleanser' for the singer: 'What is he hiding?'	relationship
Travis Kelce shares how Taylor Swift romance began	Travis Kelce shared details about how his love story with Taylor Swift began, revealing he had some help from her family members.	relationship
Joy Behar doesn’t want Taylor Swift stuck with ‘idiot’ Travis Kelce	The View' host Joy Behar doesn't want Taylor Swift to be 'stuck with this idiot' Travis Kelce after several of his posts making disparaging comments about women resurfaced online: 'He’s illiterate.'	relationship
The Marvels' has MCU's worst box office opening ever	The Marvels' went lower, nearer, and slower with MCU's worst box office opening ever, grossing $47 million.	unrelated
Taylor Swift changes 'Karma' lyric for Travis Kelce at Eras concert	Taylor Swift shouted out Travis Kelce in a 'Karma' lyric change at a show in Argentina: 'Karma is the guy on the Chiefs, coming straight home to me.'	music
Mean Girls' movie musical trailer brings back the Plastics	The first-look trailer at the 'Mean Girls' movie musical sees the likes of Regina George, Cady Heron, Janis Ian, and more — now with more music.	unrelated
See NSYNC's troll transformation in 'Trolls Band Together'	The members of NSYNC are getting a sparkly troll transformation in 'Trolls Band Together' — here's your first look.	unrelated
Big Brother' host Julie Chen Moonves teases 'Legends' season	Big Brother' host Julie Chen Moonves teases that a possible winter 'Legends' season or celebrity edition could be in the works.	unrelated
The Voice' adds Wynonna Judd as Mega Mentor for season 24	Country icon Wynonna Judd is joining 'The Voice' as a Mega Mentor for season 24.	unrelated
Five Nights at Freddy's debuts to $78 million	Five Nights at Freddy's' tops the weekend box office with $78M, the biggest opening for a horror movie in 2023.	unrelated
Taylor Swift: The Eras Tour' tops domestic box office for 2nd week	Killers of the Flower Moon' eclipsed by 'Taylor Swift: The Eras Tour' domestically, but debuts at No. 1 globally.	top_chart