title	description	topic	signum
Wrongful death suit filed against top NBA pick Brandon Miller	The mother of a woman killed near the University of Alabama in January has filed a wrongful death lawsuit in federal court against Charlotte Hornets rookie Brandon Miller and two other men.		
Nolte: Taylor Swift Humiliates Hollywood Again -- Trounces Leo’s ‘Flower Moon’	"Nolte: ""Taylor Swift: The Eras Tour"" grossed another $32 million, humiliating Leonardo Di Caprio’s ""Killers of the Flower Moon,"" which debuted to just $22 million."		
'Funflation': Most Americans Cutting Back on Amusement Parks, Live Entertainment as Prices Soar Under Biden	Nearly 60 percent of Americans are cutting back on spending on live entertainment -- including amusement parks, rock concerts, and the performing arts -- as prices continue to soar through the roof, according to a new survey of 1,000 individuals conducted by …		
Gwyneth Paltrow intends to 'literally disappear'; Taylor Swift 'protected and cherished' by Travis Kelce	The Fox News Entertainment newsletter brings you the latest Hollywood headlines, celebrity interviews and stories from Los Angeles and beyond.		
Ben Simmons has his health and old job back. Now Nets need to see his old game	Reinstalled as point guard, Ben Simmons has been moving quickly and decisively again in the preseason after playing just 42 games the last two seasons. It gives the Nets hope.		
Chiefs’ Travis Kelce loses 'friendly wager,' dons Iowa State mascot headgear: 'Go Cyclones'	"Kansas City Chiefs All-Pro tight end Travis Kelce attended his Friday press conference wearing the headgear of the Iowa State mascot after losing a ""friendly wager"""		
Boomers were right! 5 things about adulting no one wants you to know	Every generation thinks it's cornered the market on brains, but you have to know what to do with them. Which is why wisdom matter. So let me offer some.		
A movie theater staffer describes what it was like to work Taylor Swift's Eras Tour film premiere, which was so loud it blew out 2 amps	Taylor Swift's Eras Tour film was so loud it blew the sound system in one theater.		
Taylor Swift and Travis Kelce, Gwen Stefani and Blake Shelton bring the romance: PHOTOS	"Taylor Swift and Travis Kelce were spotted together at a ""Saturday Night Live"" after-party, and Blake Shelton supported Gwen Stefani at her Hollywood Walk of Fame ceremony."		
Sixers will start regular season without James Harden 'unless something changes'	The Philadelphia 76ers finished their entire preseason schedule without James Harden playing for them.		
Despite three red-zone fumbles, Falcons still beat Bucs to grab first place	Both teams struggled near the goal line, but Atlanta hit a field goal as time expired to beat the Bucs and move into first place in the NFC South.		
Taylor Swift sports Travis Kelce's football jersey number on friendship bracelet at Chiefs game	Taylor Swift showed NFL fans how to support a player by wearing Travis Kelce's football jersey number on a friendship bracelet while watching Chiefs game.		
Travis Kelce's big day with Taylor Swift in attendance helps Chiefs to huge win over Chargers	Travis Kelce had a dominant performance with his rumored girlfriend, Taylor Swift, in the building during the Kansas City Chiefs' big win on Sunday.		
11 photos of Taylor Swift going through all the emotions watching Travis Kelce at the Chiefs game	Waving to fans, celebrating and more for Taylor Swift in her return to Arrowhead Stadium.		
Browns edge Myles Garrett dominates in win over Colts: 'Man, 95 is a problem'	Myles Garrett's Sunday: nine tackles, two sacks, two forced fumbles, a pass breakup and a blocked field goal. Oh, and the Browns won 39-38.		
Taylor Swift, Brittany Mahomes show off new handshakes amid monster half for Patrick Mahomes, Travis Kelce	Taylor Swift and Brittany Mahomes, the wife of star quarterback Patrick Mahomes, showcased their new touchdown handshake as their budding friendship continues.		
NFL Week 7 top viral moments: LeBron James, Taylor Swift celebrate National Tight Ends Day	There was plenty to buzz about on social media during an action-packed NFL slate. Check out the moments that had the internet talking here!		
Taylor Swift returns to Arrowhead stadium to cheer on Travis Kelce	This is the fifth time Swift has been seen cheering on Kansas Chiefs tight end Travis Kelce and the defending Super Bowl champions.		
Jay Glazer: Cardinals want to build around Kyler Murray, not trade him	"NFL insider Jay Glazer joined David Helman to discuss Kyler Murray trade rumors on another segment of ""Ask Glazer"" on the ""NFL on FOX Pod"""		
'Taylor Swift: The Eras Tour' tops domestic box office for 2nd week	'Killers of the Flower Moon' eclipsed by 'Taylor Swift: The Eras Tour' domestically, but debuts at No. 1 globally.		
Video: Taylor Swift, Brittany Mahomes Celebrate With Handshake at Chargers vs. Chiefs	Kansas City Chiefs wide receiver Marquez Valdes-Scantling wasn't the only one excited to see Patrick Mahomes throw his first deep touchdown pass of the season…		
CBS actually broke out a hilarious graphic about Travis Kelce's stats with Taylor Swift in attendance	Incredible work. No notes.		
NFL Week 7 top viral moments: LeBron James loves big days from Myles Garrett, Lamar Jackson	There was plenty to buzz about on social media during an action-packed NFL slate. Check out the moments that had the internet talking here!		
Browns' PJ Walker leads controversial game-winning drive to defeat Colts on the road	Cleveland Browns quarterback P.J. Walker, playing for the injured Deshaun Watson, led a controversial game-winning drive over the Indianapolis Colts on Sunday.		
Taylor Swift sports new friendship bracelet with beau Travis Kelce’s jersey number on it at Chiefs game	This is basically the 2023 version of wearing a letter jacket, right?		
Taylor Swift and Brittany Mahomes shared a silly pregame dance in the duo’s return to KC	Taylor Swift and Brittany Mahomes had some adorable fun in their return to Arrowhead Stadium.		
Taylor Swift spotted at Chiefs-Chargers game at Arrowhead Stadium	Taylor Swift has touched down in Kansas City to attend the Chiefs' home game against the Chargers.		
Taylor Swift is still in her (Chiefs) Red era with latest appearance supporting Travis Kelce at football game | CNN	In a surprise to absolutely nobody, Taylor Swift was back in Kansas City on Sunday to support Travis Kelce at his football game.		
NFL Week 7 Top viral moments: LeBron James loves big days from Myles Garrett, Lamar Jackson	There was plenty to buzz about on social media during an action-packed NFL slate. Check out the moments that had the internet talking here!		
Taylor Swift takes in Chargers-Chiefs at Arrowhead in Week 7	Taylor Swift is back at Arrowhead Stadium for the second week in a row to watch the Los Angeles Chargers take on the Kansas City Chiefs.		
Taylor Swift watches football with former NFL quarterback Bernie Kosar before attending Chiefs game	Taylor Swift is back at Arrowhead Stadium to catch her rumored beau Travis Kelce, but before attending the game, she watched the early games with Bernie Kosar.		
Lamar Jackson Leads the Best Performers of Week 7 in the NFL	Quarterbacks took the stage again this week, leading their teams to victory.		
Taylor Swift was the soundtrack to my Killers of the Flower Moon screening	Did you hear Taylor Swift: The Eras Tour while trying to watch Martin Scorsese’s latest movie? You aren’t alone.		
The Philadelphia Eagles' signature 'tush push' is effectively driving its critics mad	"Philadelphia and Jalen Hurts beat the Miami Dolphins on Sunday. The Eagles' only crime with its ""brotherly shove"" is making football fourth downs less dramatic."		
Mom's creepy-cool Taylor Swift Halloween display goes viral on TikTok	"A Wisconsin mom has gone viral after she shared her creative Taylor Swift Eras Tour Halloween decor with fellow ""Swifties"" on TikTok, reaching millions of people."		
Travis Kelce dazzled in Week 7. Is he 'showing off' for Taylor Swift?	"Travis Kelce had a huge 179-yard performance in Week 7, making some NFL fans wonder if he's ""showing off"" for Taylor Swift. And maybe that's a good thing."		
Taylor Swift kisses Travis Kelce on the cheek in Instagram photo	Taylor Swift and Travis Kelce are getting just a little bit more cozy in a new snap that has fans buzzing.		
Chiefs' Travis Kelce has been taking his play to a new level with Taylor Swift in the house	Kansas City Chiefs tight end Travis Kelce has been taking his play to a new level whenever Taylor Swift is in the house		
Taylor Swift kisses Travis Kelce following Kansas City Chiefs game	Taylor Swift and Travis Kelce's romance heats up as a new photo of the pop star kissing the NFL tight end's cheek surfaced after she attended Sunday's Kansas City Chiefs game.		
NFL Week 7 Winners and Losers: Eagles Slow Down Dolphins Offense in SNF Win	The Eagles managed to mostly contain the top-ranked Dolphins offense in a 31-17 win on Sunday Night Football.		
Travis Kelce trying to impress Taylor Swift is GREAT for Chiefs | What’s Wright?	The Kansas City Chiefs were able to take care of business against the Los Angeles Chargers, soundly defeating them at home in Arrowhead 31-17. So how do Patrick Mahomes’ Chiefs avoid complacency with that challenge out of the way? Nick Wright points to one fa…		
Travis Kelce's dad says he's impressed by Taylor Swift after meeting pop star	"Despite Travis Kelce joking that his father meeting Taylor Swift was ""terrifying,"" Ed Kelce reportedly had a great first impression of the pop star."		
Taylor Swift fans aren't going to be happy with Terry Bradshaw's Eras Tour lip sync theory	Taylor Swift fans might have some beef with Terry Bradshaw over this one.		
Are you washing your jeans enough? — plus Kirk Cameron's powerful plea	The Fox News Lifestyle Newsletter brings you trending stories on family, travel, food, neighbors helping neighbors, pets, autos, military veterans, heroes, faith and American values.		
Taylor Swift secures Travis Kelce's dad's stamp of approval in glowing review: 'Very special'	Taylor Swift seemingly earned a stamp up of approval from new beau Travis Kelce's father. Ed Kelce shared insight into his relationship with the pop star in a new interview.		
Taylor Swift Effect: Chiefs 5-0, 4-1 ATS since star began attending Travis Kelce games	Travis Kelce and the Chiefs are on fire since superstar Taylor Swift started attending games. Patrick Everson talked to a long-time bookmaker about Kelce's props and how Swift has impacted the betting markets.		
Taylor Swift fans worry after she spends time with Jackson Mahomes, Britney Spears shares why she goes nude	The Fox News Entertainment newsletter brings you the latest Hollywood headlines, celebrity interviews and stories from Los Angeles and beyond.		
What to Know About the Dolly Parton Event Hitting Theaters Soon	"The first-listen event for Parton's new ""Rockstar"" album is set to land in theaters on November 15."		
Chiefs' Travis Kelce responds to Andy Reid's comments on the impact of Taylor Swift	"Travis Kelce is thankful for coach Andy Reid's approval of the presence of Taylor Swift at Chiefs games: ""You know you're doing something right."""		
Union Berlin are no longer an underdog fairytale, but they're worth rooting for	Union Berlin's players couldn't believe the support of their home fans as their losing streak stretched to nine games on Tuesday night. But that's what makes this club, and its supporters, so special.		
Rob Gronkowski's claim that Taylor Swift gets too much NFL airtime is overblown	Come on, Gronk. You're wrong about this one.		
Connor Hellebuyck and his wife debut first of many Travis Kelce and Taylor Swift Halloween costumes this season	The Taylor Swift and Travis Kelce Halloween costumes are beginning to roll in.		
Chiefs' Travis Kelce Will Have Feature on Jason Kelce, Eagles' 2nd Christmas Album	Travis Kelce starts dating Taylor Swift and all of a sudden the Kansas City Chiefs star embarks on a musical career. Travis and brother Jason announced…		
Chiefs' Travis Kelce Addresses Viral Taylor Swift Stat Graphic from Chargers Game	Kansas City Chiefs star Travis Kelce is well aware of the difference in his performance this season when Taylor Swift is at his games as opposed to when she's…		
Buccaneers vs. Bills live updates: Top moments from Thursday Night Football	Week 8 of the NFL season gets underway Thursday with the Bills playing host to the Buccaneers. Here are the top moments!		
Taylor Swift is now a billionaire, Bloomberg says | CNN Business	Taylor Swift has another accolade to add to her already impressive resume this year: America’s favorite pop star is now a billionaire, according to a Bloomberg analysis.		
‘1989 (Taylor’s Version)’ is coming. Here’s what to know.	‘1989 (Taylor’s Version)’ features vault tracks: “Now That We Don’t Talk,” “Suburban Legends,” “Say Don’t Go,” “Is It Over Now?” and “‘Slut!’”		
Trevor Lawrence to Trey Lance: Grading the 2021 quarterback class so far	Former NFL scout Bucky Brooks checks in on the quarterback class of 2021, grading the five first-round picks on their performances so far.		
Taylor Swift achieves billionaire status amid monumental Eras tour	According to a Bloomberg News Analysis published Thursday, Taylor Swift's net worth is $1.1 billion.		
FOX Super 6 NFL contest: Chris 'The Bear' Fallica's Week 8 picks	"The FOX Super 6 NFL contest has already given away $70,000. Will you be the next winner? If you need a little help with this week's questions, Chris ""The Bear"" Fallica has you covered!"		
Taylor Swift fans are convinced 1989 (Taylor’s Version) could be a double album, and they might be right	Are the Swifties on to something here?		
Jerry Jones gives mixed signals on Cowboys' trade deadline approach	"Cowboys owner Jerry Jones said there will be a ""high bar"" to trade but indicated his team will be active ahead of the Oct. 31 deadline."		
Country musician Megan Moroney says she writes sad songs for sad people. It's making her a star.	Not so long before her platinum single “Tennessee Orange” became inescapable on country radio, Megan Moroney was attending the University of Georgia		
Sam Darnold next to take turn in 49ers’ QB carousel: NFC West Stock Watch	With Brock Purdy in concussion protocol, veteran Sam Darnold could be the fifth QB to take meaningful snaps in the Niners' past 27 games.		
GOP rising star Mark Robinson’s wretched Facebook feed lands him in trouble ... again	North Carolina’s lieutenant governor, a rising star in the GOP, appears to have posted comments on Facebook quoting Hitler and minimizing the Holocaust.		
The Hottest Costume This Halloween? The All-American Couple	What this year's most popular Halloween costumes say about our current attitudes		
Patrick Mahomes wants to 'one-up' Taylor Swift and his wife's handshake with Travis Kelce	When Taylor Swift and Patrick Mahomes' wife went viral for their two handshakes, the quarterback realized he didn't have one with Travis Kelce.		
Chiefs star Travis Kelce dances to Taylor Swift's 'Shake It Off' at World Series game	The Kansas City Chiefs star broke out some dance moves to one of Taylor Swift's hit songs during his appearance at Game 1 of the World Series between the Rangers and Diamondbacks.		
Jennifer Lawrence's full-frontal nude scene; Morgan Wallen looks for love	The Fox News Entertainment newsletter brings you the latest Hollywood headlines, celebrity interviews and stories from Los Angeles and beyond.		
Taylor Swift to likely miss Travis Kelce's Chiefs game this Sunday as 'Eras Tour' nears return: reports	The Grammy Award winning singer has become a fixture at Chiefs home and road games so far this season, where she has supported Travis Kelce from luxury suites.		
Britney Spears and Jada Pinkett Smith demonstrate the delicate dance of the celeb memoir	Would you want to revisit your life and your past in order to share it all, both the good and the bad?		
Apple’s Journal app is kind of smart — and kind of basic	Apple Journal comes with iOS 17.2 and includes features for saving photos, video, text, and more. It also includes a suggestions API that uses AI to try and guess which moments matter most.		
TMZ: Taylor Swift Won't Attend Travis Kelce, Chiefs' Game vs. Broncos in Week 8	Travis Kelce will be left to his own devices when the Kansas City Chiefs play the Denver Broncos on Sunday. Per TMZ Sports, Taylor Swift won't be attending…		
Chiefs lose, Travis Kelce has a tough day in Taylor Swift's absence	High-profile tight end Travis Kelce underperformed against expectations Sunday in the Kansas City Chiefs' loss to the Denver Broncos — and his reported sweetheart, Taylor Swift, wasn't there to see it.		
Five Nights at Freddy's debuts to $78 million	'Five Nights at Freddy's' tops the weekend box office with $78M, the biggest opening for a horror movie in 2023.		
AJ Brown sets NFL record as Eagles use second-half surge to beat Commanders	Philadelphia Eagles star wide receiver A.J. Brown was back dazzling everyone on Sunday as he broke the NFL record for most 125-plus receiving yards in six straight games.		
NFL Week 8 top viral moments: Best Halloween costumes from around the league	It's Halloween weekend in the NFL, and several players are getting into the spooky spirit with some epic costumes! Check out the best ones we saw here.		
Taylor Swift has the most adorable stand-in for Chiefs - Broncos: A Corgi dressed like her	Likely not going to see the real Taylor Swift in Denver today, but you do get a super cute stand-in.		
Video game adaptation 'Five Nights at Freddy's' tops weekend box office even with simultaneous streaming release	The Blumhouse production adapts the game in which a security guard has to fend off murderous animatronic characters at a family pizza restaurant.		
Video game adaptation ‘Five Nights at Freddy’s’ notches $130 million global debut	Fans flocked to movie theaters across the country to see the scary video game adaptation “Five Nights at Freddy's” on the big screen, which made $78 million to top the North American box office		
Halloween candy vs. healthy parenting: Here's how to make it all work	Parenting is hard, especially with candy companies trying turn Halloween into an all-year sugar-buzz festival. We can help them grow without ruining their childhoods.		
Apple is getting ready for Prime Time	Apple’s big Prime Time event may end up being some iMacs and MacBooks, but given the company’s increased ambitions in Hollywood it could be more.		
Who Is Chargers Superfan Merianne Do? 5 Things We Know After She Went Viral	Los Angeles Chargers fan Merianne Do went viral when the Chargers played the Dallas Cowboys for her wild celebrations. What do we know about her?		
Your guide to the internet’s most (and least) important moments	Plus a new Leica camera, the Quiche browser, the Hugo Awards, Google Maps, and more in this week’s Installer newsletter.		
How to watch tonight's Chicago Bears vs. Los Angeles Chargers NFL game: Livestream options, starting time, more	The Bears face the Chargers for an epic Week-8 matchup that has both teams hungry for a win.		
How to watch today's Cincinnati Bengals vs. San Francisco 49ers NFL game: Livestream options, starting time	Here's how and when to watch today's game between the Cincinnati Bengals and San Francisco 49ers.		
How to watch today's Kansas City Chiefs vs. Denver Broncos NFL game: Livestream options, starting time, more	Travis Kelce and the Kansas City Chiefs hit the road to face Russell Wilson and the struggling Denver Broncos.		
How to watch today's Baltimore Ravens vs. Arizona Cardinals NFL game: Livestream options, starting time, more	Here's how and when to watch today's game between the Baltimore Ravens and Arizona Cardinals.		
How to watch today's Cleveland Browns vs. Seattle Seahawks NFL game: Livestream options, starting time	Here's how and when to watch today's Cleveland Browns vs. Seattle Seahawks game.		
How to watch today's Philadelphia Eagles vs. Washington Commanders NFL game: livestream options, starting time	Watch the Washington Commanders try to upset the 6-1 Philadelphia Eagles in an early game today.		
How to watch today's Atlanta Falcons vs. Tennessee Titans NFL game: Livestream options, starting time, more	Here's how and when to watch today's game between the Atlanta Falcons and Tennessee Titans.		
How to watch today's Jacksonville Jaguars vs. Pittsburgh Steelers NFL game: livestream options, starting time	The Jacksonville Jaguars seek AFC South domination as they head north to face the Pittsburgh Steelers today.		
How to watch the New York Jets vs. New York Giants NFL game: Livestream options, starting time, more	In a Big Apple battle, the New York Jets take on the New York Giants in an early game today.		
How to watch today's New England Patriots vs. Miami Dolphins NFL game: Livestream options, starting time, more	The Patriots proved last week they have what it takes to win tough games. But can they beat the 5-2 Miami Dolphins?		
Taylor Swift has made Kansas City her new stomping ground — and local shops say business is booming	Kansas City was ready for it: How the city's businesses are embracing the Tayvis relationship.		
How to watch today's New Orleans Saints vs. Indianapolis Colts NFL game: LIvestream options, starting time, more	It's a must-win game for both teams today as the Indianapolis Colts host the New Orleans Saints.		
How to watch the Minnesota Vikings vs. Green Bay Packers NFL game: Livestream options, starting time, more	The Minnesota Vikings hope to keep their momentum going as they face the Green Bay Packers today.		
How to watch today's Los Angeles Rams vs. Dallas Cowboys NFL game: Livestream options, starting time, more	The Los Angeles Rams take on the Dallas Cowboys in one of the best NFL matchups of the week. Here's how to watch.		
How to watch today's Houston Texans vs. Carolina Panthers NFL game: Livestream options, starting time, more	The Houston Texans (3-3) are taking on the Carolina Panthers (0-6) this week. Here's how to watch the NFL game.		
Taylor Swift, Cardi B, extra guacamole: How New Jersey’s governor spent $12K on stadium concessions	The request came after POLITICO obtained records of taxpayer spending.		
Ice Spice turns heads in Betty Boop Halloween costume	Ice Spice has shown the world what she’s working with in her latest Halloween costume — and she wasn’t afraid to let it all hang out.		
"16 Hilarious Fails From The Internet This Week That Will Make You Laugh So Hard You'll Be Texting This Article To Your Friends Saying ""You Have To Look At This"""	I had to include the Taylor Swift pumpkin because I have been thinking about it every day.View Entire Post ›		
Shannon Sharpe: Travis Kelce at World Series Game 1 Was a 'Horrible' Look	"The former NFL tight end believes it was a ""horrible look"" for Chiefs star to travel to a World Series game on the Friday before he played the Broncos."		
‘Five Nights at Freddy’s’ dominates Halloween weekend with $78 million debut in North America	"The simultaneous release of ""Five Nights at Freddy's"" in theaters and on streaming had little impact on the film's success on the big screen Halloween weekend."		
Broncos Troll Chiefs by Playing Taylor Swift in Arena After Big Win	After their big win, the Denver Broncos used a Swift song to take a swipe against Swift's boyfriend, Travis Kelce, and his Kansas City Chiefs.		
'The Voice' adds Wynonna Judd as Mega Mentor for season 24	Country icon Wynonna Judd is joining 'The Voice' as a Mega Mentor for season 24.		
Chiefs and Patriots compete for fans and influence in Germany ahead of games in Frankfurt	Both the Patriots and the Chiefs are looking to gain bigger followings in Germany leading up to their international match in Frankfurt.		
Report: NJ Democrat Gov. Phil Murphy Spent Taxpayer Money at Taylor Swift Concert, Other Events	New Jersey Gov. Phil Murphy (D) reportedly spent taxpayer funds at stadium events, including a Taylor Swift concert.		
Fox News Politics: The next ambassador to Israel	The latest updates from the 2024 campaign trail, exclusive interviews and more Fox News politics content		
'Don't be afraid': Athletes take on Halloween in costumes	LeBron James, Giannis Antetokounmpo and more dressed up big time for Halloween.		
Mike Johnson Has Already Made His First Mistake	Speaker Johnson has caused controversy by demanding an IRS funding cut in return for aid to Israel.		
Americans Are Earning More Even as They Complain About the Economy	Wages are rising, but Americans still feel the economy is headed in the wrong direction.		
Chiefs' Travis Kelce Files for 5 Trademarks for Use on Clothing, Cereal, More	The Travis Kelce business is booming, and the Kansas City Chiefs star is looking to take advantage of it. Per trademark attorney Josh Gerben, Kelce has filed…		
Mike McDaniel hilariously could not accept that kids were dressing up as him for Halloween	Easily the funniest coach in the NFL.		
Taylor Swift, Travis Kelce Halloween costume wins friends a top prize: See their rendition of the stars	Florida friends dressed up as Taylor Swift and Travis Kelce for a Halloween costume contest and took home the grand prize. See the pair mimick the iconic duo!		
Halloween 2023: A look at the viral moments that inspired people's costumes this year	Many online are sharing their Halloween costumes that were inspired by viral moments, pop culture trends and iconic internet memes.		
New Jersey governor spent $12K on stadium events, including a Taylor Swift concert	Politico reports New Jersey Gov. Phil Murphy tapped into a taxpayer-financed expense account for nearly $12,000 at MetLife Stadium, including almost $1,000 for a Taylor Swift concert in 2018		
New Jersey governor spent $12K on stadium events, including a Taylor Swift concert	Politico reports New Jersey Gov. Phil Murphy tapped into a taxpayer-financed expense account for nearly $12,000 at MetLife Stadium, including almost $1,000 for a Taylor Swift concert in 2018		
Scarlett Johansson hits AI app with legal action for cloning her voice in an ad	Scarlett Johansson is taking legal action against an AI app developer for using her likeness in an online ad without her consent.		
Kelly Clarkson ripped her pants while filming 'Since You've Been Gone' music video: ‘I was commando’	"Kelly Clarkson revealed that she ripped her pants while filming the music video for ""Since You've Been Gone,"" when speaking to Kyle Richards."		
Travis Kelce calls Chiefs' loss to Broncos 'embarrassing'	Travis Kelce did not hold back when discussing the Chiefs' loss to the Broncos on his podcast, placing blame on the offense.		
‘Fingernails’: A form of cinematic torture	Jessie Buckley, Jeremy Allen White and Riz Ahmed star in a silly, sci-fi story of a love triangle.		
Travis Kelce laughed so hard at a 'Taylor Swift put Travis on the map' Halloween costume	Travis Kelce loved this and so did we.		
Travis Kelce really appreciated everyone dressing up as him and Taylor Swift on Halloween	All the Travis Kelce and Taylor Swift Halloween costumes were approved by the man himself!		
Video: Chiefs' Travis Kelce Reacts to Viral Taylor Swift Halloween TikTok Costume	Travis Kelce appreciates the jokes. The Kansas City Chiefs tight end reacted to a TikTok from JaxWritesSongs that played on the prank of Taylor Swift fans…		
"A Taylor Swift Airbnb is a bachelorette dream home where megafans can bask in her ""Eras"" for up to $1,400 a night"	"You can rent this Taylor Swift Airbnb in Scottsdale, Arizona. Each room is devoted to a different era, from ""Reputation"" to ""Lover"" to ""Folklore."""		
Get Your Parkas Ready For December 2024 – Canadian Swifties Haven't Been Able To Focus Since Taylor Swift JUST Announced Three New Concert Dates	Step 1) Register for Verified Fan Presale on Ticketmaster. Step 2) Look at flights to Vancouver.View Entire Post ›		
FOX Super 6 NFL contest: Chris 'The Bear' Fallica's Week 9 picks	"The FOX Super 6 NFL contest has already given away $80,000. Will you be the next winner? If you need a little help, Chris ""The Bear"" Fallica has you covered with his picks."		
Canada’s economy faces $900-billion mortgage renewal shock	The biggest shock awaits variable-rate mortgages set to renew in 2026. A five-year variable mortgage renewing in October of that year would see payments jump 76 per cent if mortgage rates stayed around 6 per cent		
Taylor Lautner simply can’t stop backflipping at Taylor Swift’s events	Taylor Lautner, of Twilight fame, has backflipped not once but twice at Taylor Swift Eras Tour events. Apparently, he did it due to anxiety.		
Travis Kelce plays into joke that Taylor Swift 'put me on the map'	"Travis Kelce is getting in on the joke that Taylor Swift put him ""on the map."" The narrative even inspired a couple's Halloween costume, which Kelce ""enjoyed."""		
Mike Clay's NFL Betting Playbook for Week 9	Mike Clay pits his projection system against the sportsbooks with a game-by-game look at Week 9 player props, offering his leans for taking the over or the under.		
NewJeans says they’re more than solely K-pop stars as they break global barriers	NewJeans is reflecting on being the first K-pop girl group to be nominated for the “Top Billboard Global (Excl. U.S.) Artist” award.		
Travis Kelce's Stylist Responds to Taylor Swift Wardrobe Conspiracies	The Kansas City Chiefs star has worn clothes that look like Easter Eggs for Swift's fans. Were the nods to Swift's work intentional?		
Taylor Swift to bring Eras Tour to Vancouver for 3 nights in December 2024	Taylor Swift is preparing to bring her Eras Tour to Vancouver for three nights next December.		
Tyreek Hill jokes Taylor Swift fans are 'a dangerous crew' after Travis Kelce question	He knew it would be trouble if he said something negative about Taylor Swift and Travis Kelce.		
Travis Kelce asked if he's 'in love' with Taylor Swift, addresses relationship 'status'	"Travis Kelce and Taylor Swift are all but officially official, which prompted a reporter in Germany to ask the Chiefs star if he's ""in love."""		
Vancouver hotels rooms already sold out for Taylor Swift's 2024 concert dates	Vancouver is expecting an economic boon from Taylor Swift's 2024 concert dates, but Swifties are already finding hotel rooms sold out.		
See NSYNC's troll transformation in 'Trolls Band Together'	The members of NSYNC are getting a sparkly troll transformation in 'Trolls Band Together' — here's your first look.		
A Reporter Asked Travis Kelce The Status Of His Relationship With Taylor Swift, And Fans Love His Response	Travis is keeping his cards close to his chest.View Entire Post ›		
How to watch every Kansas City Chiefs game this season	We've got all the information you need to watch every Chiefs game this season (even the one that isn't on network TV).		
Travis Kelce won't say if Taylor Swift will be in Germany and jokingly blames oddsmakers for it	Those pesky oddsmakers always getting in the way		
How Taylor Swift could make it to a Travis Kelce Chiefs Super Bowl while on tour, according to Drew Barrymore	Drew Barrymore figured out how Taylor Swift could see Travis Kelce play the Super Bowl in person.		
Kelce: Chiefs have every piece needed to be great	The Chiefs heading into Sunday's game against the Dolphins haven't been an offensive power like in previous seasons. But tight end Travis Kelce said that's not because the Chiefs are deficient at wide receiver.		
Taylor Swift’s Eras Tour concert film takes its final bow at the box office this weekend	Taylor Swift takes her final bow at the movie box office this weekend.		
Taylor Swift and Beyoncé concert tours deliver record-breaking earnings for Live Nation	Live Nation has Taylor Swift and Beyoncé to thank for propelling the live concerts organizer to its strongest quarterly results to date.		
Will Taylor Swift be at the Chiefs’ game in Germany? Travis Kelce wouldn’t say	Travis Kelce declined to discuss Taylor Swift’s status for the Chiefs' game Sunday in Germany — but left the door open.		
Travis Kelce Addresses Whether He Is in Love With Taylor Swift	The Kansas City Chiefs star kept his cards close to the vest when a reporter in Germany asked him about his feelings for Swift.		
Travis Kelce has the smoothest answer when asked if he's in love with Taylor Swift	"IS TRAVIS KELCE IN LOVE WITH TAYLOR SWIFT? He actually has an answer beyond ""no comment."""		
Will Taylor Swift be at the Chiefs' game in Germany? Travis Kelce wouldn't say	Travis Kelce has declined to discuss Taylor Swift’s status for Sunday’s game in Germany — and their status as a couple		
Why Travis Kelce and the Chiefs are playing in Germany in Week 9, explained	Here's the answer.		
Big Weekend: Rich Eisen reflects on NFL Network turning 20 and calling Chiefs-Dolphins on Sunday	Rich Eisen has had many memorable moments during his long tenure at NFL Network		
Fantasy Football Week 9 Rankings: Each Position's Flex and PPR Projections	Let's break down some PPR rankings. Below, we've compiled the rankings for quarterbacks, running backs, wide receivers and tight ends utilizing Fantasy Pros'…		
Riley Gaines says 'transphobe' accusations carry 'literally no weight'	Former NCAA swimmer Riley Gaines made an appearance at UC Davis earlier this week, where she continued to fight for fairness in girls' and women's sports.		
Travis Kelce Said 'I'm Gonna Find a Breeder' Months Before Dating Taylor Swift	"""Mr. Taylor Swift"" Travis Kelce of the Kansas City Chiefs made headlines Saturday after an unearthed podcast revealed the tight end saying he was looking for a ""breeder"" to ""get kids"" just months before he started dating the singer."		
Chiefs want to be ‘world’s team’ behind star power, Super Bowl success	Can the Chiefs rule the world? With championships, Patrick Mahomes, Travis Kelce — and Taylor Swift! — why not?		
Bears, Montez Sweat agree to $98 million extension shortly after trading for him: reports	Montez Sweat and the Chicago Bears have reportedly agreed to a four-year, $98 million extension less than a week after he was traded to the team.		
Chiefs want to be 'world's team' by going global with star power and Super Bowl success	The Kansas City Chiefs say Sunday's game in Frankfurt against the Miami Dolphins is a big step in the organization's plan to become the “world’s team.”		
2023 NFL Odds: Taylor Swift's presence in Germany could affect betting market	You guessed it: Taylor Swift is now affecting the betting market. And whether or not she makes it to Germany for Sunday's game could affect Travis Kelce player props.		
Amazon Echo Show 8 (3rd gen) review: the near-perfect smart display for most households	The Amazon Echo Show 8 (3rd gen) is better than ever, coming in strong with much-needed upgrades from the previous generation. Is it finally time to move on from smart speakers and get the best of both worlds instead?		
Travis Kelce Roasted by Social Media Users for His Trademark Filings	The Kansas City Chiefs star might have spotted a few business opportunities as his relationship with Taylor Swift raises his profile.		
NFL Nation update: Invest in Raiders?	Our NFL Nation reporters answer key questions heading into the weekend's games, including what to expect from the Raiders and the Saints' Taysom Hill.		
Gen Z's financial icons revealed: Taylor Swift beats Warren Buffett, and Bill Gates tops the list	Bill Gates, Beyoncé, and Oprah Winfrey made the list of people who embody financial success for Gen Z, according to a new survey of college students.		
These 34 Beauty Products Are So Amazing A Wizard Must’ve Cast A Spell On Each Of Them	You won't even need a fairy godmother to give you a ~magical~ makeover because these products have you covered.View Entire Post ›		
Travis Kelce's New Business Venture Isn't a Touchdown With Chiefs Fans	Think Travis Kelce has the Midas touch? Well, one of his newer endeavors isn't receiving the greatest reception online.		
Taylor Swift and Brittany Mahomes had dinner in NYC with Selena Gomez instead of going to Germany and we get it	Swift didn't make the trip to Europe with the next international leg of The Eras Tour starting soon.		
A muted box office weekend without ‘Dune: Part Two’	Universal and Blumhouse's video game adaptation “Five Nights at Freddy's” topped the North American box office in its second weekend according to studio estimates Sunday, while “Taylor Swift: The Eras Tour” placed second		
Chiefs' wild fumble-return sequence leads to improbable touchdown vs Dolphins	A wild fumble return helped the Kansas City Chiefs take a comfortable lead into halftime against the Miami Dolphins in Germany on Sunday.		
Referee for Dolphins-Chiefs in Frankfurt announced a penalty in German and the home crowd loved it	Referee Clay Martin was well prepared for this moment.		
Taylor Swift, Selena Gomez, Brittany Mahomes spotted in NYC ahead of Travis Kelce's game in Germany	Taylor Swift, Selena Gomez, Sophie Turner and Gigi Hadid were spotted with Brittany Mahomes outside a New York City restaurant Saturday.		
Aaron Rodgers' Social Media Has Old Teammate Thinking About Early Return	When could Aaron Rodgers take the field for the New York Jets? A social media post may have highlighted a specific date.		
Taylor Swift supports Travis Kelce with rare social media move	Taylor Swift liked an Instagram post about Travis Kelce's performance from his game in Germany on Sunday, sending fans into a frenzy over the public act of support.		
Taylor Swift’s latest master stroke is a blockbuster re-recording of her breakthrough pop album—and it could reshape the music industry as we know it	"The newest version of ""1989 TV,"" released at the end of October, sold 1.65 million copies in its first week. ""It's a career-defining moment."""		
Taylor Swift reporter hired at Gannett after viral job listing | CNN	Consider journalist Bryan West the “lucky one,” because he’s The Tennessean and USA Today network’s new Taylor Swift Reporter.		
Jason Kelce Got Drug Test From NFL After Big Birthday Win	The Philadelphia Eagles center also had a viral altercation with Dallas Cowboys linebacker Damone Clark on a busy Sunday.		
Taylor Swift reportedly hosted wives of Travis Kelce's teammates at a Chiefs watch party	Wives of Travis Kelce's teammates were seen leaving Swift's Tribeca home on Sunday.		
Taylor Swift Went Out With A Large Group Of Famous Girlfriends, And It's Just Looking Worse And Worse For Joe Jonas	I imagine them doing some sort of Hocus Pocus hexing spell while eating the biggest ball of burrata you've ever seen.View Entire Post ›		
Giants' Daniel Jones suffers torn ACL, season likely over for star QB	New York Giants quarterback Daniel Jones will miss the rest of the season as Brian Daboll announced he tore his ACL in Sunday's game against the Las Vegas Raiders.		
Taylor Swift adds Brittany Mahomes to her squad | CNN	Taylor Swift adds Brittany Mahomes to her squad | CNNcnn.com		
Brittany Mahomes shared a glimpse of what it was like to hang out with Taylor Swift in NYC	Swift spent time with the spouses of three Chiefs' players this past weekend.		
Taylor Swift Calls on Fans to Hit the Polls Ahead of Major Elections in Several States	Pop star Taylor Swift, the jet-setting climate change activist who endorses Democrats, attacks Republicans, and performs for Communist human rights abusing-China’s Singles Day, took to social media on Tuesday to encourage her fans in certain states to vote on…		
5 wildest NFL betting moments (so far) this season, including Patrick Mahomes' slide	There have been plenty of bad beats so far this NFL season.		
A 35-year-old ‘huge Swiftie’ beat out a White House reporter and a legion of bloggers to get the most coveted job in journalism	It’s “no different than being a sports journalist who’s a fan of the home team,” said Bryan West, the new Taylor Swift reporter for USA Today.		
Report: Taylor Swift hosted watch party for Chiefs significant others Sunday	Taylor Swift reportedly hosted a watch party to root on rumored boyfriend Travis Kelce as the Chiefs took on the Dolphins in Germany last Sunday.		
Taylor Swift & Brittany Mahomes party before Chiefs game, King Charles' reported control over Harry & Meghan	The Fox News Entertainment newsletter brings you the latest Hollywood headlines, celebrity interviews and stories from Los Angeles and beyond.		
Voters to decide KY governor, OH abortion rights and VA legislative control... Developing...	"Voters to decide KY governor, OH abortion rights and VA legislative control... Developing...

 
 
 
 (First column, 1st story, link)

 

 

 
 Related stories:Dems seek upset in MS gov race...
Youngkin's Presidential Ambitions Face Test..."		
Concert movies are the future of pop music fandom	Taylor Swift, BTS, and Beyoncé’s concert movies level the field for fans. Once considered secondary to live shows, filmed concerts are now essential to fandom.		
Rob Schneider Under Fire Over Travis Kelce Comment	"""Not true just more lies,"" one person wrote, while another added: ""Not sure Travis knows who Rob even is."""		
Does Taylor Swift really swing betting odds when she's at Chiefs games?	As absurd as the premise sounds that the mere presence of a songstress love interest could appeal to the oddsmakers' soft side, there is at least a statistical starting point for a discussion.		
USA Today hires a Taylor Swift reporter. Who is he?	Gannett, the biggest newspaper chain in the U.S., no longer has a blank space under the title of “Taylor Swift reporter.”		
Movie Review: Nicolas Cage finds fame to be highly overrated in chillingly funny ‘Dream Scenario’	Nicolas Cage, perhaps best known for his onscreen volatility, takes a fascinating swerve to play a mundane, schlubby, balding professor at nowhere famous in Kristoffer Borgli's “Dream Scenario.”		
Taylor Swift Promoted Left-Wing Voter Registration Organization While Remaining Silent on Hamas' Massacre of Israelis	Mega pop star Taylor Swift used her massive social media following to promote a left-wing voter registration organization on election day. But the singer continues to remain silent on Hamas' massacre of Israelis more than a month after the October 7 slaughter.		
Travis Kelce Might Go 'Closer to the Equator' During Chiefs Bye Week	"On his podcast, the Kansas City Chiefs star told his brother Jason that he plans to go ""somewhere sunny"" during his week off."		
Taylor Swift's Argentina concert takes political turn as presidential election nears	Politics was suddenly a topic of conversation as thousands of Taylor Swift fans eagerly lined up for the superstar’s first-ever concert in Argentina		
Taylor Swift's Argentina concert takes political turn as presidential election nears	Politics was suddenly a topic of conversation as thousands of Taylor Swift fans eagerly lined up for the superstar’s first-ever concert in Argentina		
How to watch or stream Thursday Night Football’s Week 10 during the 2023 NFL season live online free without cable	Here's how to watch Thursday Night Football during the 2023 NFL season online for free—even without a cable subscription.		
Mom told to remove decorations from son's gravesite — plus Taylor Swift 'swear jar' goes viral	The Fox News Lifestyle Newsletter brings you trending stories on family, travel, food, neighbors helping neighbors, pets, autos, military veterans, heroes, faith and American values.		
An expensing firm CFO just revealed how remote work changes employee perks	For proof, take a look at the $21,000 VIP dinner, $350 haircut, and Taylor Swift concert tickets that workers got reimbursed last year.		
NC State football perfectly invoked Taylor Swift for Payton Wilson's postseason awards campaign	This is a winning combo.		
Far-right hosts are blaming the GOP's big election losses on Taylor Swift	Right-wing activist Jack Posobiec and commentator Charlie Kirk both blamed Taylor Swift's political power for electoral losses.		
Tumblr is reportedly on life support as its latest owner reassigns staff	"""600+ person-years of effort"" have not stopped the site from losing $30M a year."		
Dry Swifties or Wet Swifties? This Buenos Aires weather report (Taylor's version) is too funny	The buzz is high in Argentina with the Eras Tour starting back up.		
What to Watch Out For on the Next Leg of Taylor Swift’s Eras Tour	The singer has finished the first U.S. leg of her historically popular Eras Tour and is headed to South America.		
Travis Kelce Reportedly Will Travel to Argentina to Visit Taylor Swift	The Kansas City Chiefs star will use the team's bye week to visit Swift during the international leg of her Eras Tour.		
Taylor Swift postpones Argentina concert after Travis Kelce arrives	"Taylor Swift canceled the Nov. 10 concert of the international leg of ""The Eras Tour"" due to ""chaotic"" weather. Her rumored boyfriend, Travis Kelce, just arrived in the country."		
Argentina Socialists Weaponize Taylor Swift Against Conservative Presidential Frontrunner	Leftist fans of Taylor Swift in Argentina launched a campaign urging fellow Swifties not to vote for libertarian economist Javier Milei.		
"SZA leads Grammy nominations, up for ""Album of the Year"" with Miley Cyrus, Taylor Swift and Janelle Monáe"	"The 66th Grammy Awards nominations have been announced and SZA tops the list with nods in nine categories. Joe Levy, a contributor editor for ""Rolling Stone,"" joins CBS News with a look at the artists nominated."		
Biden Gets Bad Economic News as Polls Spell Disaster	Consumers expect inflation to be high in 2024 just as President Joe Biden will be seeking re-election.		
Taylor Swift reschedules ‘Eras Tour’ performance	Taylor Swift reschedules ‘Eras Tour’ performancecnn.com		
AMC Theatres posts best revenue and attendance since pandemic began as it closes money-losing locations and rakes in cash from 'Barbenheimer' bonanza	The mega movie theater chain has closed 156 locations since the start of the pandemic.		
Taylor Swift cancels Friday night show in Buenos Aires after Travis Kelce arrives in Argentina	Taylor Swift called off her Friday night Eras Tour show in Buenos Aires due to intense rain even after Travis Kelce showed up to watch her perform.		
Taylor Swift fans swoon over Travis Kelce’s hours-long red-eye flight to be at the Eras Tour in Argentina	Travis Kelce took an overnight flight some 5,600 miles across the globe to be there for Taylor Swift!		
2024 Grammy nomination snubs and surprises: No K-pop, little country and regional Mexican music	With new categories, “Barbie” and SZA — there’s a lot to discuss regarding the 2024 Grammy Award nominations		
Classes on celebrities like Taylor Swift and Rick Ross are engaging a new generation of law students	A South Dakota law professor who typically teaches torts and natural resources is turning his attention to Taylor Swift next semester		
Classes on celebrities like Taylor Swift and Rick Ross are engaging a new generation of law students	A South Dakota law professor who typically teaches torts and natural resources is turning his attention to Taylor Swift next semester		
Insider Today: Financial freedom's reality	Two people who consider themselves financially free shared a glimpse of what their lives are like — and it's actually a lot of work.		
Young Taylor Swift fans go viral for struggling to open the star's CD: 'Making me laugh'	Three Taylor Swift fans, ages 11 and 12, go viral after a video of their struggles to open a CD grab over 2.7 million views — and even Swift herself responded.		
Cornwall unveils winter housing plan in shadow of encampment resident's death	An eastern Ontario city's plan to house homeless people this winter is being met with a mix of relief and regret, coming less than a week after a homeless woman died in a local encampment.		
Roles reversed: Kelce uses bye week to attend Swift's performance	After weeks of Taylor Swift making headlines for attending Chiefs games, it was Travis Kelce's turn to garner attention with his appearance in Buenos Aires.		
'The Marvels' has MCU's worst box office opening ever	'The Marvels' went lower, nearer, and slower with MCU's worst box office opening ever, grossing $47 million.		
‘The Marvels’ struggles at box office amid superhero fatigue: ‘The growth of the genre has stopped’	The 33rd installment in the Marvel Cinematic Universe managed less than a third of the $153.4 million its predecessor launched with.		
House may consider Mayorkas impeachment this week	The House may consider a resolution this week that aims to impeach Homeland Security Secretary Alejandro Mayorkas after a push by Rep. Marjorie Taylor Greene (R-Ga.) to do so, according to the chamber’s schedule of measures it plans to consider. The Mayorkas …		
WATCH: Taylor Swift and Travis Kelce share a kiss after her Buenos Aires concert	Video shows the singer and Chiefs’ tight end embracing each other after her show.		
10 of Taylor Swift and Travis Kelce's most heartwarming moments from The Eras Tour in Argentina	Taylor Swift and Travis Kelce had the absolute best time Saturday night.		
Taylor Swift changes 'Karma' lyric for Travis Kelce at Eras concert	Taylor Swift shouted out Travis Kelce in a 'Karma' lyric change at a show in Argentina: 'Karma is the guy on the Chiefs, coming straight home to me.'		
Travis Kelce Saw Taylor Swift Perform in Argentina. Here's What Happened	Kelce was spotted at Swift's Eras Tour show in Argentina on Saturday, with the pop star having a surprise in store for her guest.		
Travis Kelce reacts to Taylor Swift changing 'Karma' lyrics to reference the Chiefs	Kansas City Chiefs tight end Travis Kelce appeared just as surprised as concertgoers when he received an onstage shoutout from Taylor Swift during her Eras Tour show in Argentina.		
The Marvels Wins the Box Office But Has the Worst MCU Opening Weekend of All Time	While The Marvels may have won the domestic weekend box office, it also had the worst MCU opening of all time with ticket sales of $47.0 million.		
Taylor Swift changes lyrics to ‘Karma’ in nod to ‘guy on the Chiefs’ Travis Kelce | CNN	Taylor Swift winked at her romance with Kansas City Chiefs’ tight end Travis Kelce during her “Eras Tour” concert in Buenos Aires, Argentina on Saturday when she changed the lyrics to a line in her hit song “Karma,” and Kelce was in the audience to catch it.		
Taylor Swift's dad (an Eagles fan!) wore a Chiefs lanyard while with Travis Kelce at the Eras Tour	Taylor Swift fans loved this. Eagles fans? Not so much.		
Patrick Mahomes Joining ESPN's ManningCast After Failed 'Audition' For Show	The Kansas City Chiefs quarterback was featured in an Omaha Productions skit with Peyton and Eli Manning over the summer.		
US professors use pop culture icons like Taylor Swift and Rick Ross to make law school more engaging	Law professors across the U.S. are incorporating pop culture icons like Taylor Swift and Rick Ross into their courses in an effort to engage students.		
The Taylor Swift bowl, Victor Wembanyama vs. Chet Holmgren and more on this week's betting calendar	NFL Week 11 features a rematch of Super Bowl 57 between the Eagles and Chiefs.		
"Taylor Swift Expressed Her Discomfort With Fans Throwing Stuff Onstage: ""It Really Freaks Me Out"""	Everyone needs to chill.View Entire Post ›		
Taylor Swift fans think her grateful message to Buenos Aires used one of Travis Kelce's favorite phrases	Maybe Taylor Swift already has the word “electric” in her vocabulary — heck, she has a song called Electric Touch! — to describe the die-hard crowds during the Eras Tour, bu…		
NFL Finally Dumps Taylor Swift from Social Media, Replaces Her with Vikings' Josh Dobbs	After a 42-day run, the NFL has finally removed images and tributes to pop star Taylor Swift as the features on its social media accounts.		
Josh Dobbs Isn't a Just Viral Story, He's a Valuable Lesson for Sports Fans	While the Vikings quarterback has become the talk of the NFL over the past couple of weeks, he's more than just a feel-good story.		
Brutal Travis and Jason Kelce Comparison Goes Viral	"Jason Kelce was a finalist for People Magazine's ""Sexiest Man of the Year"" 2023, while brother Travis Kelce didn't make list."		
Taylor Swift concert postponement prompts airline to waive change fee | CNN	LATAM Airlines waived its change fees for customers who wanted to extend their stay in Buenos Aires, Argentina, after Taylor Swift postponed her concert there.		
Travis Kelce, Taylor Swift budding relationship draws wholesome remark from Andy Reid	Kansas City Chiefs head coach Andy Reid remarked on Travis Kelce's relationship with Taylor Swift as he spent his bye week in Argentina to see the pop star.		
Chiefs' Travis Kelce joins Jason Kelce on 'A Philly Special Christmas' single	"Travis Kelce joined his brother, Jason, to sing a holiday song for the second edition of the album ""A Philly Special Christmas."""		
Will Taylor Swift fans send the Travis and Jason Kelce holiday song to No. 1?	That's right, the Kelce brothers have a holiday song coming out!		
Google sues people who “weaponized” DMCA to remove rivals’ search results	Google says DMCA fraudsters filed copyright takedown notices for 600,000+ URLs.		
Why football in Premier League and Europe is anything but a fair fight	It's not surprising that big teams with lots of resources and money might win more trophies -- just look at Man City's dominance in recent seasons -- but what might surprise you is the sheer scale of this inequality.		
Andy Reid Says Opposing Coaches Don't Call Him About Taylor Swift	"The Kansas City Chiefs coach said he is happy that star tight end Travis Kelce has ""found somebody he likes."""		
Jason Kelce Came Into Her Hot Dog Restaurant and 'Tried To Roast the Queen'	The Eagles center made a good impression on employees at Wiener's Circle, including resident trash-talker Poochie Rollins.		
'A noisy rock 'n' roll': How growing interest in Formula One is felt across the music world	Beyond the engineering, the athleticism, the speed, the luxury, fans love the sound of Formula One		
'A noisy rock 'n' roll': How growing interest in Formula One is felt across the music world	Beyond the engineering, the athleticism, the speed, the luxury, fans love the sound of Formula One		
Gigi Hadid Breaks Silence on Taylor Swift's Romance With Travis Kelce	Gigi Hadid has denied she doesn't approve of Taylor Swift's relationship with football star Travis Kelce moving so fast.		
Taylor Swift surprises Travis Kelce at concert, pleads with fans to stop throwing things on stage	The Fox News Entertainment newsletter brings you the latest Hollywood headlines, celebrity interviews and stories from Los Angeles and beyond.		
Patrick Mahomes says he’s worn the same pair of underwear every game since his first NFL season	Travis Kelce spent the Kansas City Chiefs’ bye week carousing through South America with Taylor Swift.		
Travis Kelce’s old tweets are resurfacing online, and some Swifties are here for it	Taylor Swift and Travis Kelce's viral public relationship has captivated the internet. Now, so have some of Kelce’s old tweets.		
Patriots legend Rob Gronkowski says Mac Jones should ask for release now: 'He's not respected'	Mac Jones' tenure with the New England Patriots has hit rock bottom at 2-8 in his third season, and legend Rob Gronkowski believes he should ask for his release now.		
Donna Kelce discusses seeing The Eras Tour movie and whether Taylor Swift will be there for Chiefs - Eagles	"Momma Kelce said the film adaptation of the popular tour was ""amazing."""		
Report: Travis Kelce, Taylor Swift's Parents Expected to Meet at Eagles vs. Chiefs	Travis Kelce and Taylor Swift appear to be taking the next step in their relationship. The parents of the Chiefs tight end and world-renowned…		
Olive Garden chimes in on an old Travis Kelce tweet with a fun Taylor Swift lyric change	Let's head down to the ole Garden and get some breadsticks and listen to Taylor Swift.		
Fans speculate Travis Kelce keeps texting Taylor Swift during episodes of New Heights podcast	Honestly, if we could text Taylor Swift, we'd be doing it all the time, too.		
Travis Kelce's Old Tweets Are Going Viral, And It's Making Everyone Like Him 1,000 Times More	This is the next-level himbo Ken energy, and I love it.View Entire Post ›		
Travis Kelce says Taylor Swift's lyric change at Argentina concert 'shocked' him	"Taylor Swift referenced Travis Kelce in a song and embraced the Chiefs star during her ""Eras Tour"" international concert series."		
Travis Kelce's astonishingly philosophical tweet from 2012 had Taylor Swift fans making so many jokes	When you take your first philosophy class ...		
'Kelce' becomes a top trending dog name in America, pet company's data shows	"Recent data from Rover has shown that a top trending dog name in America right now is ""Kelce,"" amid coverage of the Kansas City Chiefs player and girlfriend Taylor Swift."		
Eagles' Kelce: 'I don't buy into' revenge games	Eagles center Jason Kelce said he does not buy into revenge games ahead of Monday night's showdown against the Kansas City Chiefs, who beat the Eagles 38-35 in last year's Super Bowl.		
Travis Kelce's Old Tweets Reposted by Taylor Swift Fans Ahead of Eagles vs. Chiefs	Taylor Swift fans are a passionate, unique bunch. Swifties have been digging into the old tweets of Travis Kelce, Swift's current beau, to the point that many…		
'It's refreshing': Wall Street analysts show they're Taylor Swift superfans too by riffing on her songs in their usually wonky research notes	Analysts are giving a nod to Swift’s reign at the pinnacle of pop culture by referencing her lyrics in their financial research.		
Travis Kelce Now Has a No. 1 Song to His Name	Think Taylor Swift is the only one with musical talent? Travis Kelce appeared on a song, and it's performing rather well.		
Michigan's Jim Harbaugh agrees to serve 3-game ban, Big Ten drops sign-stealing investigation	Michigan coach Jim Harbaugh agreed to serve a 3-game suspension over the school's sign-stealing scandal and the Big Ten has dropped its investigaton.		
Philadelphia Radio Station Won't Play Taylor Swift Songs Ahead of Eagles vs. Chiefs	While pop superstar Taylor Swift is a native of Pennsylvania and grew up a Philadelphia Eagles fan, her allegiance to Kansas City Chiefs star tight end Travis…		
Brazil's Christ the Redeemer statue welcomes Taylor Swift with unique display	Taylor Swift and the Eras Tour will receive a special welcome to Rio de Janeiro on Thursday night with a projection on the city's iconic Christ the Redeemer.		
Travis Kelce's old tweets unearthed; Taco Bell, Olive Garden, Chipotle respond	Taylor Swift fans have resurfaced old Travis Kelce tweets amid reports that the duo's parents will meet at the Chiefs-Eagles game.		
Joy Behar doesn’t want Taylor Swift stuck with ‘idiot’ Travis Kelce	'The View' host Joy Behar doesn't want Taylor Swift to be 'stuck with this idiot' Travis Kelce after several of his posts making disparaging comments about women resurfaced online: 'He’s illiterate.'		
How to watch tonight's Cincinnati Bengals vs. Baltimore Ravens game on TNF: Livestream options, kickoff time	Here's how to watch Lamar Jackson and the Baltimore Ravens face Joe Burrow and the Cincinnati Bengals on TNF.		
Travis Kelce's Unintentionally Hilarious Unearthed Tweets Have Officially Become A Meme	He's all of us.View Entire Post ›		
The 5 most watchable NFL games for Week 11 2023, ranked	Here are the best games to watch in Week 11.		
Taylor Swift fans think Eras Tour bracelets lit up with Chiefs colors during her End Game performance	Big reputations and now gold and red bracelets!		
VIDEO — 'Precious': Donald Trump Visits His Granddaughter at School	Former President Donald Trump visited his granddaughter, Carolina, at school, and the little girl showed her grandpa her desk.		
Taylor Swift fans used record amounts of data during the Eras Tour in North America	A staggering 29 terabytes of glitter moved through AT&T’s network during her stop in Arlington, Texas, and Swifties set data usage records almost everywhere else.		
Philly radio station 'punts' Swift from weekend playlist ahead of Chiefs-Eagles	Taylor Swift grew up an Eagles fan, but her relationship with Chiefs tight end Travis Kelce is causing one Philadelphia radio station to take no chances.		
KELCE?! The Surprising Most Popular New Pet Names in American Study	The report shows that U.S. pet owners have quite the sense of humor.		
The 23 most delightfully goofy Travis Kelce tweets unearthed by Taylor Swift fans	These are all so wholesome.		
3 ways to increase your privacy and save money when booking travel	"Kurt ""CyberGuy"" Knutsson takes on protecting privacy and saving money while booking travel plans through the use of creating an email alias."		
Travis Kelce apologizes to Taylor Swift’s dad | CNN	Remember when Travis Kelce said he was going to stick to talking about football and not his private life? Good thing for the Swifties it looks like he didn’t mean it.		
NHTSA misses deadline on potentially life-saving new rules for vehicle seats	The National Highway Traffic Safety Administration was supposed to propose new vehicle safety regulations by Nov. 15.		
Celebrities Who Refuse to Perform in Israel	Roger Waters of Pink Floyd has been a prominent critic of Israel but other musicians have also turned down the chance to play in the country, albeit less vocally.		
Drew Barrymore doesn't want plastic surgery: 'I worry I'd continue to chase it'	"Drew Barrymore says that she's never had plastic surgery and doesn't picture herself getting any, saying her ""highly addictive personality"" might cause her to go overboard."		
Rooms, an interactive 3D space designer and ‘cozy game,’ arrives on the App Store	Cozy game, interior decorating app, learn-to-code primer, or something in between, the interactive, 3D spaces builder known as Rooms has made its way to the App Store. The startup, which earlier raised $10 million in seed funding led by a16z, offers a way to …		
Eagles' Jason Kelce on Chiefs Matchup: 'I Don't Buy into Super Bowl Revenge Games'	While most of the coverage for the upcoming Monday Night Football game between the Philadelphia Eagles and Kansas City Chiefs is describing it as a rematch of…		
Taylor Swift 'overwhelmed by grief,' postpones Rio show after fan dies during Eras Tour concert	Taylor Swift postponed an Eras Tour concert in Rio de Janeiro Saturday after a 23-year-old fan died during her Friday night show, according to a message posted on the singer's Instagram.		
2023 College Football, NFL odds: Best bets for Washington-Oregon State, Eagles-Chiefs	Sammy P took a look at the weekend football slate to serve up his best bets. Read to see who he likes in the Kansas State-Kansas matchup and which Pac-12 contest he's betting to go Over.		
Taylor Swift postpones Eras Tour concert in Rio de Janeiro due to heat	Taylor Swift announced that her concert scheduled for Saturday in Rio de Janeiro, Brazil has been postponed due to high temperatures.		
Taylor Swift postpones Rio show after a fan's death during her Friday night concert	Taylor Swift postpones Rio show after a fan's death during her Friday night concert		
Taylor Swift postpones Brazil concert due to 'extreme temperatures'	"Taylor Swift announced that her Saturday night Eras concert in Rio de Janeiro has been postponed due to ""extreme temperatures."""		
Taylor Swift postpones Rio show after a fan's death during her Friday night concert	Taylor Swift postpones Rio show after a fan's death during her Friday night concert		
Taylor Swift postpones Rio show after a fan's death during her Friday night concert	Taylor Swift postpones Rio show after a fan's death during her Friday night concert		
Taylor Swift fan dies before 'The Eras Tour' concert in Rio de Janeiro, Brazil	Taylor Swift fan dies before 'The Eras Tour' concert in Rio de Janeiro, Brazilgo.com		
Fans think this 2009 Travis Kelce tweet about college football is just so relatable	2009 Travis Kelce was just having a good time.		
Rio de Janeiro Officials Project Taylor Swift Welcome onto Famed 'Christ the Redeemer' Statue	Officials in Rio de Janeiro were so excited about pop star Taylor Swift's imminent concerts in Brazil that they electronically projected a Swifty-themed robe onto its famed Christ the Redeemer statue that overlooks the glittering city.		
Taylor Swift fan dies at Rio concert amid complaints about excessive heat	"Swift posted in her Instagram stories after news of the fan's death writing she has ""a shattered heart."""		
Taylor Swift fan details scorching, 'sauna-like' conditions at Brazil show that left 23-year-old dead	A passionate Taylor Swift fan gave a glimpse of her experience at the chaotic Brazil concert that left a 23-year-old person dead after severe weather conditions.		
Taylor Swift Fan Dies at Rio Concert as Fans Complain About High Temperatures and Lack of Water	RIO DE JANEIRO (AP) — A 23-year-old Taylor Swift fan died at the singer’s Eras Tour concert in Rio de Janeiro Friday night, according to a statement from the show’s organizers in Brazil.		
Taylor Swift Fan Dies Before Eras Concert in Rio, Attendees Complain About Venue Conditions	A 23-year-old fan died at the Eras Tour concert in Rio on Friday night, according to a statement from the show's organizers in Brazil.		
"Taylor Swift postpones Rio show over ""extreme weather"" after fan's death"	Taylor Swift postponed a concert in Rio de Janeiro, Brazil, after a 23-year-old fan died during the Friday night show of Swift's Eras Tour.		
Patrick Mahomes approves of Travis Kelce's relationship with Taylor Swift: 'It's not become a distraction'	Chiefs quarterback Patrick Mahomes gave his stamp of approval of Travis Kelce's relationship with Taylor Swift, saying it's not a distraction to the guys in the locker room.		
How to watch or stream Week 11 of the NFL’s 2023 season football live online free without cable	Here's how to watch Week 11 of the 2023 NFL season and your favorite football teams play online for free—even without a cable subscription.		
Taylor Swift postpones Rio show one day after fan's death, citing 'extreme temperatures'	Apparent temperature — a combination of temperature and humidity — hit 138 degrees Friday morning in Rio, the highest index ever recorded there.		
'Kelce Bowl' Between Chiefs, Eagles Has Some Historic Hype Behind It	The Chiefs (7-2) and Eagles (8-1) are both atop their respective conferences heading into their Super Bowl rematch.		
Taylor Swift Postpones Rio Concert Amid Safety Concerns Following Fan’s Death	Taylor Swift took to social media on Saturday evening to announce that she was postponing her concert, amid concerns over safety.		
NFL Week 11 preview: Chiefs-Eagles headline schedule as eyes turn back to Travis Kelce, Taylor Swift	NFL fans and the pop culture world will likely be tuning in Monday night for the Kansas City Chiefs and Philadelphia Eagles, but don't count out Sunday's slate.		
How Patriots coach Bill Belichick helped Josh Uche ignore the trade deadline noise	"Uche credits ""some open, transparent dialogue with Bill"" for helping him work through hearing his name involved in trade buzz."		
How to watch the Philadelphia Eagles vs. Kansas City Chiefs game on Monday Night Football: Livestream options	A rematch of Super Bowl LVII, the Philadelphia Eagles face the Kansas City Chief and brothers Jason Kelce and Travis Kelce face off.		
How to watch the Minnesota Vikings vs. Denver Broncos NFL game: Livestream options, kickoff time, more	Watch Josh Dobbs and the Minnesota Vikings face the Denver Broncos in Week 11. Here's how to watch the game.		
How to watch today's Tampa Bay Buccaneers vs. San Francisco 49ers NFL game: Livestream options, kickoff time	The San Francisco 49ers hope to keep the winning going as they face the Tampa Bay Buccaneers. Here's how to watch.		
